instant,dteday,season,yr,mnth,holiday,weekday,workingday,weathersit,temp,atemp,hum,windspeed,casual,registered,cnt,Recency,Frequency,Monetary,Cluster
1,2011-01-01,Spring,2011,1,0,6,0,Cloudy,0.344167,0.363625,0.805833,0.160446,331,654,985,730,1,985,1
2,2011-01-02,Spring,2011,1,0,0,0,Cloudy,0.363478,0.353739,0.696087,0.248539,131,670,801,729,2,801,1
3,2011-01-03,Spring,2011,1,0,1,1,Clear,0.196364,0.189405,0.437273,0.248309,120,1229,1349,728,3,1349,1
4,2011-01-04,Spring,2011,1,0,2,1,Clear,0.2,0.212122,0.590435,0.160296,108,1454,1562,727,4,1562,1
5,2011-01-05,Spring,2011,1,0,3,1,Clear,0.226957,0.22927,0.436957,0.1869,82,1518,1600,726,5,1600,1
6,2011-01-06,Spring,2011,1,0,4,1,Clear,0.204348,0.233209,0.518261,0.0895652,88,1518,1606,725,6,1606,1
7,2011-01-07,Spring,2011,1,0,5,1,Cloudy,0.196522,0.208839,0.498696,0.168726,148,1362,1510,724,7,1510,1
8,2011-01-08,Spring,2011,1,0,6,0,Cloudy,0.165,0.162254,0.535833,0.266804,68,891,959,723,8,959,1
9,2011-01-09,Spring,2011,1,0,0,0,Clear,0.138333,0.116175,0.434167,0.36195,54,768,822,722,9,822,1
10,2011-01-10,Spring,2011,1,0,1,1,Clear,0.150833,0.150888,0.482917,0.223267,41,1280,1321,721,10,1321,1
11,2011-01-11,Spring,2011,1,0,2,1,Cloudy,0.169091,0.191464,0.686364,0.122132,43,1220,1263,720,11,1263,1
12,2011-01-12,Spring,2011,1,0,3,1,Clear,0.172727,0.160473,0.599545,0.304627,25,1137,1162,719,12,1162,1
13,2011-01-13,Spring,2011,1,0,4,1,Clear,0.165,0.150883,0.470417,0.301,38,1368,1406,718,13,1406,1
14,2011-01-14,Spring,2011,1,0,5,1,Clear,0.16087,0.188413,0.537826,0.126548,54,1367,1421,717,14,1421,1
15,2011-01-15,Spring,2011,1,0,6,0,Cloudy,0.233333,0.248112,0.49875,0.157963,222,1026,1248,716,15,1248,1
16,2011-01-16,Spring,2011,1,0,0,0,Clear,0.231667,0.234217,0.48375,0.188433,251,953,1204,715,16,1204,1
17,2011-01-17,Spring,2011,1,1,1,0,Cloudy,0.175833,0.176771,0.5375,0.194017,117,883,1000,714,17,1000,1
18,2011-01-18,Spring,2011,1,0,2,1,Cloudy,0.216667,0.232333,0.861667,0.146775,9,674,683,713,18,683,1
19,2011-01-19,Spring,2011,1,0,3,1,Cloudy,0.292174,0.298422,0.741739,0.208317,78,1572,1650,712,19,1650,1
20,2011-01-20,Spring,2011,1,0,4,1,Cloudy,0.261667,0.25505,0.538333,0.195904,83,1844,1927,711,20,1927,1
21,2011-01-21,Spring,2011,1,0,5,1,Clear,0.1775,0.157833,0.457083,0.353242,75,1468,1543,710,21,1543,1
22,2011-01-22,Spring,2011,1,0,6,0,Clear,0.0591304,0.0790696,0.4,0.17197,93,888,981,709,22,981,1
23,2011-01-23,Spring,2011,1,0,0,0,Clear,0.0965217,0.0988391,0.436522,0.2466,150,836,986,708,23,986,1
24,2011-01-24,Spring,2011,1,0,1,1,Clear,0.0973913,0.11793,0.491739,0.15833,86,1330,1416,707,24,1416,1
25,2011-01-25,Spring,2011,1,0,2,1,Cloudy,0.223478,0.234526,0.616957,0.129796,186,1799,1985,706,25,1985,1
26,2011-01-26,Spring,2011,1,0,3,1,Rain,0.2175,0.2036,0.8625,0.29385,34,472,506,705,26,506,1
27,2011-01-27,Spring,2011,1,0,4,1,Clear,0.195,0.2197,0.6875,0.113837,15,416,431,704,27,431,1
28,2011-01-28,Spring,2011,1,0,5,1,Cloudy,0.203478,0.223317,0.793043,0.1233,38,1129,1167,703,28,1167,1
29,2011-01-29,Spring,2011,1,0,6,0,Clear,0.196522,0.212126,0.651739,0.145365,123,975,1098,702,29,1098,1
30,2011-01-30,Spring,2011,1,0,0,0,Clear,0.216522,0.250322,0.722174,0.0739826,140,956,1096,701,30,1096,1
31,2011-01-31,Spring,2011,1,0,1,1,Cloudy,0.180833,0.18625,0.60375,0.187192,42,1459,1501,700,31,1501,1
32,2011-02-01,Spring,2011,2,0,2,1,Cloudy,0.192174,0.23453,0.829565,0.053213,47,1313,1360,699,32,1360,1
33,2011-02-02,Spring,2011,2,0,3,1,Cloudy,0.26,0.254417,0.775417,0.264308,72,1454,1526,698,33,1526,1
34,2011-02-03,Spring,2011,2,0,4,1,Clear,0.186957,0.177878,0.437826,0.277752,61,1489,1550,697,34,1550,1
35,2011-02-04,Spring,2011,2,0,5,1,Cloudy,0.211304,0.228587,0.585217,0.127839,88,1620,1708,696,35,1708,1
36,2011-02-05,Spring,2011,2,0,6,0,Cloudy,0.233333,0.243058,0.929167,0.161079,100,905,1005,695,36,1005,1
37,2011-02-06,Spring,2011,2,0,0,0,Clear,0.285833,0.291671,0.568333,0.1418,354,1269,1623,694,37,1623,1
38,2011-02-07,Spring,2011,2,0,1,1,Clear,0.271667,0.303658,0.738333,0.0454083,120,1592,1712,693,38,1712,1
39,2011-02-08,Spring,2011,2,0,2,1,Clear,0.220833,0.198246,0.537917,0.36195,64,1466,1530,692,39,1530,1
40,2011-02-09,Spring,2011,2,0,3,1,Cloudy,0.134783,0.144283,0.494783,0.188839,53,1552,1605,691,40,1605,1
41,2011-02-10,Spring,2011,2,0,4,1,Clear,0.144348,0.149548,0.437391,0.221935,47,1491,1538,690,41,1538,1
42,2011-02-11,Spring,2011,2,0,5,1,Clear,0.189091,0.213509,0.506364,0.10855,149,1597,1746,689,42,1746,1
43,2011-02-12,Spring,2011,2,0,6,0,Clear,0.2225,0.232954,0.544167,0.203367,288,1184,1472,688,43,1472,1
44,2011-02-13,Spring,2011,2,0,0,0,Clear,0.316522,0.324113,0.457391,0.260883,397,1192,1589,687,44,1589,1
45,2011-02-14,Spring,2011,2,0,1,1,Clear,0.415,0.39835,0.375833,0.417908,208,1705,1913,686,45,1913,1
46,2011-02-15,Spring,2011,2,0,2,1,Clear,0.266087,0.254274,0.314348,0.291374,140,1675,1815,685,46,1815,1
47,2011-02-16,Spring,2011,2,0,3,1,Clear,0.318261,0.3162,0.423478,0.251791,218,1897,2115,684,47,2115,1
48,2011-02-17,Spring,2011,2,0,4,1,Clear,0.435833,0.428658,0.505,0.230104,259,2216,2475,683,48,2475,1
49,2011-02-18,Spring,2011,2,0,5,1,Clear,0.521667,0.511983,0.516667,0.264925,579,2348,2927,682,49,2927,1
50,2011-02-19,Spring,2011,2,0,6,0,Clear,0.399167,0.391404,0.187917,0.507463,532,1103,1635,681,50,1635,1
51,2011-02-20,Spring,2011,2,0,0,0,Clear,0.285217,0.27733,0.407826,0.223235,639,1173,1812,680,51,1812,1
52,2011-02-21,Spring,2011,2,1,1,0,Cloudy,0.303333,0.284075,0.605,0.307846,195,912,1107,679,52,1107,1
53,2011-02-22,Spring,2011,2,0,2,1,Clear,0.182222,0.186033,0.577778,0.195683,74,1376,1450,678,53,1450,1
54,2011-02-23,Spring,2011,2,0,3,1,Clear,0.221739,0.245717,0.423043,0.094113,139,1778,1917,677,54,1917,1
55,2011-02-24,Spring,2011,2,0,4,1,Cloudy,0.295652,0.289191,0.697391,0.250496,100,1707,1807,676,55,1807,1
56,2011-02-25,Spring,2011,2,0,5,1,Cloudy,0.364348,0.350461,0.712174,0.346539,120,1341,1461,675,56,1461,1
57,2011-02-26,Spring,2011,2,0,6,0,Clear,0.2825,0.282192,0.537917,0.186571,424,1545,1969,674,57,1969,1
58,2011-02-27,Spring,2011,2,0,0,0,Clear,0.343478,0.351109,0.68,0.125248,694,1708,2402,673,58,2402,1
59,2011-02-28,Spring,2011,2,0,1,1,Cloudy,0.407273,0.400118,0.876364,0.289686,81,1365,1446,672,59,1446,1
60,2011-03-01,Spring,2011,3,0,2,1,Clear,0.266667,0.263879,0.535,0.216425,137,1714,1851,671,60,1851,1
61,2011-03-02,Spring,2011,3,0,3,1,Clear,0.335,0.320071,0.449583,0.307833,231,1903,2134,670,61,2134,1
62,2011-03-03,Spring,2011,3,0,4,1,Clear,0.198333,0.200133,0.318333,0.225754,123,1562,1685,669,62,1685,1
63,2011-03-04,Spring,2011,3,0,5,1,Cloudy,0.261667,0.255679,0.610417,0.203346,214,1730,1944,668,63,1944,1
64,2011-03-05,Spring,2011,3,0,6,0,Cloudy,0.384167,0.378779,0.789167,0.251871,640,1437,2077,667,64,2077,1
65,2011-03-06,Spring,2011,3,0,0,0,Cloudy,0.376522,0.366252,0.948261,0.343287,114,491,605,666,65,605,1
66,2011-03-07,Spring,2011,3,0,1,1,Clear,0.261739,0.238461,0.551304,0.341352,244,1628,1872,665,66,1872,1
67,2011-03-08,Spring,2011,3,0,2,1,Clear,0.2925,0.3024,0.420833,0.12065,316,1817,2133,664,67,2133,1
68,2011-03-09,Spring,2011,3,0,3,1,Cloudy,0.295833,0.286608,0.775417,0.22015,191,1700,1891,663,68,1891,1
69,2011-03-10,Spring,2011,3,0,4,1,Rain,0.389091,0.385668,0.0,0.261877,46,577,623,662,69,623,1
70,2011-03-11,Spring,2011,3,0,5,1,Cloudy,0.316522,0.305,0.649565,0.23297,247,1730,1977,661,70,1977,1
71,2011-03-12,Spring,2011,3,0,6,0,Clear,0.329167,0.32575,0.594583,0.220775,724,1408,2132,660,71,2132,1
72,2011-03-13,Spring,2011,3,0,0,0,Clear,0.384348,0.380091,0.527391,0.270604,982,1435,2417,659,72,2417,1
73,2011-03-14,Spring,2011,3,0,1,1,Clear,0.325217,0.332,0.496957,0.136926,359,1687,2046,658,73,2046,1
74,2011-03-15,Spring,2011,3,0,2,1,Cloudy,0.317391,0.318178,0.655652,0.184309,289,1767,2056,657,74,2056,1
75,2011-03-16,Spring,2011,3,0,3,1,Cloudy,0.365217,0.36693,0.776522,0.203117,321,1871,2192,656,75,2192,1
76,2011-03-17,Spring,2011,3,0,4,1,Clear,0.415,0.410333,0.602917,0.209579,424,2320,2744,655,76,2744,1
77,2011-03-18,Spring,2011,3,0,5,1,Clear,0.54,0.527009,0.525217,0.231017,884,2355,3239,654,77,3239,2
78,2011-03-19,Spring,2011,3,0,6,0,Clear,0.4725,0.466525,0.379167,0.368167,1424,1693,3117,653,78,3117,1
79,2011-03-20,Spring,2011,3,0,0,0,Clear,0.3325,0.32575,0.47375,0.207721,1047,1424,2471,652,79,2471,1
80,2011-03-21,Summer,2011,3,0,1,1,Cloudy,0.430435,0.409735,0.737391,0.288783,401,1676,2077,651,80,2077,1
81,2011-03-22,Summer,2011,3,0,2,1,Clear,0.441667,0.440642,0.624583,0.22575,460,2243,2703,650,81,2703,1
82,2011-03-23,Summer,2011,3,0,3,1,Cloudy,0.346957,0.337939,0.839565,0.234261,203,1918,2121,649,82,2121,1
83,2011-03-24,Summer,2011,3,0,4,1,Cloudy,0.285,0.270833,0.805833,0.243787,166,1699,1865,648,83,1865,1
84,2011-03-25,Summer,2011,3,0,5,1,Clear,0.264167,0.256312,0.495,0.230725,300,1910,2210,647,84,2210,1
85,2011-03-26,Summer,2011,3,0,6,0,Clear,0.265833,0.257571,0.394167,0.209571,981,1515,2496,646,85,2496,1
86,2011-03-27,Summer,2011,3,0,0,0,Cloudy,0.253043,0.250339,0.493913,0.1843,472,1221,1693,645,86,1693,1
87,2011-03-28,Summer,2011,3,0,1,1,Clear,0.264348,0.257574,0.302174,0.212204,222,1806,2028,644,87,2028,1
88,2011-03-29,Summer,2011,3,0,2,1,Clear,0.3025,0.292908,0.314167,0.226996,317,2108,2425,643,88,2425,1
89,2011-03-30,Summer,2011,3,0,3,1,Cloudy,0.3,0.29735,0.646667,0.172888,168,1368,1536,642,89,1536,1
90,2011-03-31,Summer,2011,3,0,4,1,Rain,0.268333,0.257575,0.918333,0.217646,179,1506,1685,641,90,1685,1
91,2011-04-01,Summer,2011,4,0,5,1,Cloudy,0.3,0.283454,0.68625,0.258708,307,1920,2227,640,91,2227,1
92,2011-04-02,Summer,2011,4,0,6,0,Cloudy,0.315,0.315637,0.65375,0.197146,898,1354,2252,639,92,2252,1
93,2011-04-03,Summer,2011,4,0,0,0,Clear,0.378333,0.378767,0.48,0.182213,1651,1598,3249,638,93,3249,2
94,2011-04-04,Summer,2011,4,0,1,1,Clear,0.573333,0.542929,0.42625,0.385571,734,2381,3115,637,94,3115,1
95,2011-04-05,Summer,2011,4,0,2,1,Cloudy,0.414167,0.39835,0.642083,0.388067,167,1628,1795,636,95,1795,1
96,2011-04-06,Summer,2011,4,0,3,1,Clear,0.390833,0.387608,0.470833,0.263063,413,2395,2808,635,96,2808,1
97,2011-04-07,Summer,2011,4,0,4,1,Clear,0.4375,0.433696,0.602917,0.162312,571,2570,3141,634,97,3141,1
98,2011-04-08,Summer,2011,4,0,5,1,Cloudy,0.335833,0.324479,0.83625,0.226992,172,1299,1471,633,98,1471,1
99,2011-04-09,Summer,2011,4,0,6,0,Cloudy,0.3425,0.341529,0.8775,0.133083,879,1576,2455,632,99,2455,1
100,2011-04-10,Summer,2011,4,0,0,0,Cloudy,0.426667,0.426737,0.8575,0.146767,1188,1707,2895,631,100,2895,1
101,2011-04-11,Summer,2011,4,0,1,1,Cloudy,0.595652,0.565217,0.716956,0.324474,855,2493,3348,630,101,3348,2
102,2011-04-12,Summer,2011,4,0,2,1,Cloudy,0.5025,0.493054,0.739167,0.274879,257,1777,2034,629,102,2034,1
103,2011-04-13,Summer,2011,4,0,3,1,Cloudy,0.4125,0.417283,0.819167,0.250617,209,1953,2162,628,103,2162,1
104,2011-04-14,Summer,2011,4,0,4,1,Clear,0.4675,0.462742,0.540417,0.1107,529,2738,3267,627,104,3267,2
105,2011-04-15,Summer,2011,4,1,5,0,Clear,0.446667,0.441913,0.67125,0.226375,642,2484,3126,626,105,3126,1
106,2011-04-16,Summer,2011,4,0,6,0,Rain,0.430833,0.425492,0.888333,0.340808,121,674,795,625,106,795,1
107,2011-04-17,Summer,2011,4,0,0,0,Clear,0.456667,0.445696,0.479583,0.303496,1558,2186,3744,624,107,3744,2
108,2011-04-18,Summer,2011,4,0,1,1,Clear,0.5125,0.503146,0.5425,0.163567,669,2760,3429,623,108,3429,2
109,2011-04-19,Summer,2011,4,0,2,1,Cloudy,0.505833,0.489258,0.665833,0.157971,409,2795,3204,622,109,3204,2
110,2011-04-20,Summer,2011,4,0,3,1,Clear,0.595,0.564392,0.614167,0.241925,613,3331,3944,621,110,3944,2
111,2011-04-21,Summer,2011,4,0,4,1,Clear,0.459167,0.453892,0.407083,0.325258,745,3444,4189,620,111,4189,2
112,2011-04-22,Summer,2011,4,0,5,1,Cloudy,0.336667,0.321954,0.729583,0.219521,177,1506,1683,619,112,1683,1
113,2011-04-23,Summer,2011,4,0,6,0,Cloudy,0.46,0.450121,0.887917,0.230725,1462,2574,4036,618,113,4036,2
114,2011-04-24,Summer,2011,4,0,0,0,Cloudy,0.581667,0.551763,0.810833,0.192175,1710,2481,4191,617,114,4191,2
115,2011-04-25,Summer,2011,4,0,1,1,Clear,0.606667,0.5745,0.776667,0.185333,773,3300,4073,616,115,4073,2
116,2011-04-26,Summer,2011,4,0,2,1,Clear,0.631667,0.594083,0.729167,0.3265,678,3722,4400,615,116,4400,2
117,2011-04-27,Summer,2011,4,0,3,1,Cloudy,0.62,0.575142,0.835417,0.3122,547,3325,3872,614,117,3872,2
118,2011-04-28,Summer,2011,4,0,4,1,Cloudy,0.6175,0.578929,0.700833,0.320908,569,3489,4058,613,118,4058,2
119,2011-04-29,Summer,2011,4,0,5,1,Clear,0.51,0.497463,0.457083,0.240063,878,3717,4595,612,119,4595,2
120,2011-04-30,Summer,2011,4,0,6,0,Clear,0.4725,0.464021,0.503333,0.235075,1965,3347,5312,611,120,5312,2
121,2011-05-01,Summer,2011,5,0,0,0,Cloudy,0.451667,0.448204,0.762083,0.106354,1138,2213,3351,610,121,3351,2
122,2011-05-02,Summer,2011,5,0,1,1,Cloudy,0.549167,0.532833,0.73,0.183454,847,3554,4401,609,122,4401,2
123,2011-05-03,Summer,2011,5,0,2,1,Cloudy,0.616667,0.582079,0.697083,0.342667,603,3848,4451,608,123,4451,2
124,2011-05-04,Summer,2011,5,0,3,1,Cloudy,0.414167,0.40465,0.737083,0.328996,255,2378,2633,607,124,2633,1
125,2011-05-05,Summer,2011,5,0,4,1,Clear,0.459167,0.441917,0.444167,0.295392,614,3819,4433,606,125,4433,2
126,2011-05-06,Summer,2011,5,0,5,1,Clear,0.479167,0.474117,0.59,0.228246,894,3714,4608,605,126,4608,2
127,2011-05-07,Summer,2011,5,0,6,0,Clear,0.52,0.512621,0.54125,0.16045,1612,3102,4714,604,127,4714,2
128,2011-05-08,Summer,2011,5,0,0,0,Clear,0.528333,0.518933,0.631667,0.0746375,1401,2932,4333,603,128,4333,2
129,2011-05-09,Summer,2011,5,0,1,1,Clear,0.5325,0.525246,0.58875,0.176,664,3698,4362,602,129,4362,2
130,2011-05-10,Summer,2011,5,0,2,1,Clear,0.5325,0.522721,0.489167,0.115671,694,4109,4803,601,130,4803,2
131,2011-05-11,Summer,2011,5,0,3,1,Clear,0.5425,0.5284,0.632917,0.120642,550,3632,4182,600,131,4182,2
132,2011-05-12,Summer,2011,5,0,4,1,Clear,0.535,0.523363,0.7475,0.189667,695,4169,4864,599,132,4864,2
133,2011-05-13,Summer,2011,5,0,5,1,Cloudy,0.5125,0.4943,0.863333,0.179725,692,3413,4105,598,133,4105,2
134,2011-05-14,Summer,2011,5,0,6,0,Cloudy,0.520833,0.500629,0.9225,0.13495,902,2507,3409,597,134,3409,2
135,2011-05-15,Summer,2011,5,0,0,0,Cloudy,0.5625,0.536,0.867083,0.152979,1582,2971,4553,596,135,4553,2
136,2011-05-16,Summer,2011,5,0,1,1,Clear,0.5775,0.550512,0.787917,0.126871,773,3185,3958,595,136,3958,2
137,2011-05-17,Summer,2011,5,0,2,1,Cloudy,0.561667,0.538529,0.837917,0.277354,678,3445,4123,594,137,4123,2
138,2011-05-18,Summer,2011,5,0,3,1,Cloudy,0.55,0.527158,0.87,0.201492,536,3319,3855,593,138,3855,2
139,2011-05-19,Summer,2011,5,0,4,1,Cloudy,0.530833,0.510742,0.829583,0.108213,735,3840,4575,592,139,4575,2
140,2011-05-20,Summer,2011,5,0,5,1,Clear,0.536667,0.529042,0.719583,0.125013,909,4008,4917,591,140,4917,2
141,2011-05-21,Summer,2011,5,0,6,0,Clear,0.6025,0.571975,0.626667,0.12065,2258,3547,5805,590,141,5805,0
142,2011-05-22,Summer,2011,5,0,0,0,Clear,0.604167,0.5745,0.749583,0.148008,1576,3084,4660,589,142,4660,2
143,2011-05-23,Summer,2011,5,0,1,1,Cloudy,0.631667,0.590296,0.81,0.233842,836,3438,4274,588,143,4274,2
144,2011-05-24,Summer,2011,5,0,2,1,Cloudy,0.66,0.604813,0.740833,0.207092,659,3833,4492,587,144,4492,2
145,2011-05-25,Summer,2011,5,0,3,1,Clear,0.660833,0.615542,0.69625,0.154233,740,4238,4978,586,145,4978,2
146,2011-05-26,Summer,2011,5,0,4,1,Clear,0.708333,0.654688,0.6775,0.199642,758,3919,4677,585,146,4677,2
147,2011-05-27,Summer,2011,5,0,5,1,Clear,0.681667,0.637008,0.65375,0.240679,871,3808,4679,584,147,4679,2
148,2011-05-28,Summer,2011,5,0,6,0,Clear,0.655833,0.612379,0.729583,0.230092,2001,2757,4758,583,148,4758,2
149,2011-05-29,Summer,2011,5,0,0,0,Clear,0.6675,0.61555,0.81875,0.213938,2355,2433,4788,582,149,4788,2
150,2011-05-30,Summer,2011,5,1,1,0,Clear,0.733333,0.671092,0.685,0.131225,1549,2549,4098,581,150,4098,2
151,2011-05-31,Summer,2011,5,0,2,1,Clear,0.775,0.725383,0.636667,0.111329,673,3309,3982,580,151,3982,2
152,2011-06-01,Summer,2011,6,0,3,1,Cloudy,0.764167,0.720967,0.677083,0.207092,513,3461,3974,579,152,3974,2
153,2011-06-02,Summer,2011,6,0,4,1,Clear,0.715,0.643942,0.305,0.292287,736,4232,4968,578,153,4968,2
154,2011-06-03,Summer,2011,6,0,5,1,Clear,0.62,0.587133,0.354167,0.253121,898,4414,5312,577,154,5312,2
155,2011-06-04,Summer,2011,6,0,6,0,Clear,0.635,0.594696,0.45625,0.123142,1869,3473,5342,576,155,5342,2
156,2011-06-05,Summer,2011,6,0,0,0,Cloudy,0.648333,0.616804,0.6525,0.138692,1685,3221,4906,575,156,4906,2
157,2011-06-06,Summer,2011,6,0,1,1,Clear,0.678333,0.621858,0.6,0.121896,673,3875,4548,574,157,4548,2
158,2011-06-07,Summer,2011,6,0,2,1,Clear,0.7075,0.65595,0.597917,0.187808,763,4070,4833,573,158,4833,2
159,2011-06-08,Summer,2011,6,0,3,1,Clear,0.775833,0.727279,0.622083,0.136817,676,3725,4401,572,159,4401,2
160,2011-06-09,Summer,2011,6,0,4,1,Cloudy,0.808333,0.757579,0.568333,0.149883,563,3352,3915,571,160,3915,2
161,2011-06-10,Summer,2011,6,0,5,1,Clear,0.755,0.703292,0.605,0.140554,815,3771,4586,570,161,4586,2
162,2011-06-11,Summer,2011,6,0,6,0,Clear,0.725,0.678038,0.654583,0.15485,1729,3237,4966,569,162,4966,2
163,2011-06-12,Summer,2011,6,0,0,0,Clear,0.6925,0.643325,0.747917,0.163567,1467,2993,4460,568,163,4460,2
164,2011-06-13,Summer,2011,6,0,1,1,Clear,0.635,0.601654,0.494583,0.30535,863,4157,5020,567,164,5020,2
165,2011-06-14,Summer,2011,6,0,2,1,Clear,0.604167,0.591546,0.507083,0.269283,727,4164,4891,566,165,4891,2
166,2011-06-15,Summer,2011,6,0,3,1,Clear,0.626667,0.587754,0.471667,0.167912,769,4411,5180,565,166,5180,2
167,2011-06-16,Summer,2011,6,0,4,1,Cloudy,0.628333,0.595346,0.688333,0.206471,545,3222,3767,564,167,3767,2
168,2011-06-17,Summer,2011,6,0,5,1,Clear,0.649167,0.600383,0.735833,0.143029,863,3981,4844,563,168,4844,2
169,2011-06-18,Summer,2011,6,0,6,0,Clear,0.696667,0.643954,0.670417,0.119408,1807,3312,5119,562,169,5119,2
170,2011-06-19,Summer,2011,6,0,0,0,Cloudy,0.699167,0.645846,0.666667,0.102,1639,3105,4744,561,170,4744,2
171,2011-06-20,Summer,2011,6,0,1,1,Cloudy,0.635,0.595346,0.74625,0.155475,699,3311,4010,560,171,4010,2
172,2011-06-21,Fall,2011,6,0,2,1,Cloudy,0.680833,0.637646,0.770417,0.171025,774,4061,4835,559,172,4835,2
173,2011-06-22,Fall,2011,6,0,3,1,Clear,0.733333,0.693829,0.7075,0.172262,661,3846,4507,558,173,4507,2
174,2011-06-23,Fall,2011,6,0,4,1,Cloudy,0.728333,0.693833,0.703333,0.238804,746,4044,4790,557,174,4790,2
175,2011-06-24,Fall,2011,6,0,5,1,Clear,0.724167,0.656583,0.573333,0.222025,969,4022,4991,556,175,4991,2
176,2011-06-25,Fall,2011,6,0,6,0,Clear,0.695,0.643313,0.483333,0.209571,1782,3420,5202,555,176,5202,2
177,2011-06-26,Fall,2011,6,0,0,0,Clear,0.68,0.637629,0.513333,0.0945333,1920,3385,5305,554,177,5305,2
178,2011-06-27,Fall,2011,6,0,1,1,Cloudy,0.6825,0.637004,0.658333,0.107588,854,3854,4708,553,178,4708,2
179,2011-06-28,Fall,2011,6,0,2,1,Clear,0.744167,0.692558,0.634167,0.144283,732,3916,4648,552,179,4648,2
180,2011-06-29,Fall,2011,6,0,3,1,Clear,0.728333,0.654688,0.497917,0.261821,848,4377,5225,551,180,5225,2
181,2011-06-30,Fall,2011,6,0,4,1,Clear,0.696667,0.637008,0.434167,0.185312,1027,4488,5515,550,181,5515,2
182,2011-07-01,Fall,2011,7,0,5,1,Clear,0.7225,0.652162,0.39625,0.102608,1246,4116,5362,549,182,5362,2
183,2011-07-02,Fall,2011,7,0,6,0,Clear,0.738333,0.667308,0.444583,0.115062,2204,2915,5119,548,183,5119,2
184,2011-07-03,Fall,2011,7,0,0,0,Cloudy,0.716667,0.668575,0.6825,0.228858,2282,2367,4649,547,184,4649,2
185,2011-07-04,Fall,2011,7,1,1,0,Cloudy,0.726667,0.665417,0.637917,0.0814792,3065,2978,6043,546,185,6043,0
186,2011-07-05,Fall,2011,7,0,2,1,Clear,0.746667,0.696338,0.590417,0.126258,1031,3634,4665,545,186,4665,2
187,2011-07-06,Fall,2011,7,0,3,1,Clear,0.72,0.685633,0.743333,0.149883,784,3845,4629,544,187,4629,2
188,2011-07-07,Fall,2011,7,0,4,1,Clear,0.75,0.686871,0.65125,0.1592,754,3838,4592,543,188,4592,2
189,2011-07-08,Fall,2011,7,0,5,1,Cloudy,0.709167,0.670483,0.757917,0.225129,692,3348,4040,542,189,4040,2
190,2011-07-09,Fall,2011,7,0,6,0,Clear,0.733333,0.664158,0.609167,0.167912,1988,3348,5336,541,190,5336,2
191,2011-07-10,Fall,2011,7,0,0,0,Clear,0.7475,0.690025,0.578333,0.183471,1743,3138,4881,540,191,4881,2
192,2011-07-11,Fall,2011,7,0,1,1,Clear,0.7625,0.729804,0.635833,0.282337,723,3363,4086,539,192,4086,2
193,2011-07-12,Fall,2011,7,0,2,1,Clear,0.794167,0.739275,0.559167,0.200254,662,3596,4258,538,193,4258,2
194,2011-07-13,Fall,2011,7,0,3,1,Clear,0.746667,0.689404,0.631667,0.146133,748,3594,4342,537,194,4342,2
195,2011-07-14,Fall,2011,7,0,4,1,Clear,0.680833,0.635104,0.47625,0.240667,888,4196,5084,536,195,5084,2
196,2011-07-15,Fall,2011,7,0,5,1,Clear,0.663333,0.624371,0.59125,0.182833,1318,4220,5538,535,196,5538,2
197,2011-07-16,Fall,2011,7,0,6,0,Clear,0.686667,0.638263,0.585,0.208342,2418,3505,5923,534,197,5923,0
198,2011-07-17,Fall,2011,7,0,0,0,Clear,0.719167,0.669833,0.604167,0.245033,2006,3296,5302,533,198,5302,2
199,2011-07-18,Fall,2011,7,0,1,1,Clear,0.746667,0.703925,0.65125,0.215804,841,3617,4458,532,199,4458,2
200,2011-07-19,Fall,2011,7,0,2,1,Clear,0.776667,0.747479,0.650417,0.1306,752,3789,4541,531,200,4541,2
201,2011-07-20,Fall,2011,7,0,3,1,Clear,0.768333,0.74685,0.707083,0.113817,644,3688,4332,530,201,4332,2
202,2011-07-21,Fall,2011,7,0,4,1,Cloudy,0.815,0.826371,0.69125,0.222021,632,3152,3784,529,202,3784,2
203,2011-07-22,Fall,2011,7,0,5,1,Clear,0.848333,0.840896,0.580417,0.1331,562,2825,3387,528,203,3387,2
204,2011-07-23,Fall,2011,7,0,6,0,Clear,0.849167,0.804287,0.5,0.131221,987,2298,3285,527,204,3285,2
205,2011-07-24,Fall,2011,7,0,0,0,Clear,0.83,0.794829,0.550833,0.169171,1050,2556,3606,526,205,3606,2
206,2011-07-25,Fall,2011,7,0,1,1,Clear,0.743333,0.720958,0.757083,0.0908083,568,3272,3840,525,206,3840,2
207,2011-07-26,Fall,2011,7,0,2,1,Clear,0.771667,0.696979,0.540833,0.200258,750,3840,4590,524,207,4590,2
208,2011-07-27,Fall,2011,7,0,3,1,Clear,0.775,0.690667,0.402917,0.183463,755,3901,4656,523,208,4656,2
209,2011-07-28,Fall,2011,7,0,4,1,Clear,0.779167,0.7399,0.583333,0.178479,606,3784,4390,522,209,4390,2
210,2011-07-29,Fall,2011,7,0,5,1,Clear,0.838333,0.785967,0.5425,0.174138,670,3176,3846,521,210,3846,2
211,2011-07-30,Fall,2011,7,0,6,0,Clear,0.804167,0.728537,0.465833,0.168537,1559,2916,4475,520,211,4475,2
212,2011-07-31,Fall,2011,7,0,0,0,Clear,0.805833,0.729796,0.480833,0.164813,1524,2778,4302,519,212,4302,2
213,2011-08-01,Fall,2011,8,0,1,1,Clear,0.771667,0.703292,0.550833,0.156717,729,3537,4266,518,213,4266,2
214,2011-08-02,Fall,2011,8,0,2,1,Clear,0.783333,0.707071,0.49125,0.20585,801,4044,4845,517,214,4845,2
215,2011-08-03,Fall,2011,8,0,3,1,Cloudy,0.731667,0.679937,0.6575,0.135583,467,3107,3574,516,215,3574,2
216,2011-08-04,Fall,2011,8,0,4,1,Cloudy,0.71,0.664788,0.7575,0.19715,799,3777,4576,515,216,4576,2
217,2011-08-05,Fall,2011,8,0,5,1,Clear,0.710833,0.656567,0.630833,0.184696,1023,3843,4866,514,217,4866,2
218,2011-08-06,Fall,2011,8,0,6,0,Cloudy,0.716667,0.676154,0.755,0.22825,1521,2773,4294,513,218,4294,2
219,2011-08-07,Fall,2011,8,0,0,0,Clear,0.7425,0.715292,0.752917,0.201487,1298,2487,3785,512,219,3785,2
220,2011-08-08,Fall,2011,8,0,1,1,Clear,0.765,0.703283,0.592083,0.192175,846,3480,4326,511,220,4326,2
221,2011-08-09,Fall,2011,8,0,2,1,Clear,0.775,0.724121,0.570417,0.151121,907,3695,4602,510,221,4602,2
222,2011-08-10,Fall,2011,8,0,3,1,Clear,0.766667,0.684983,0.424167,0.200258,884,3896,4780,509,222,4780,2
223,2011-08-11,Fall,2011,8,0,4,1,Clear,0.7175,0.651521,0.42375,0.164796,812,3980,4792,508,223,4792,2
224,2011-08-12,Fall,2011,8,0,5,1,Clear,0.708333,0.654042,0.415,0.125621,1051,3854,4905,507,224,4905,2
225,2011-08-13,Fall,2011,8,0,6,0,Cloudy,0.685833,0.645858,0.729583,0.211454,1504,2646,4150,506,225,4150,2
226,2011-08-14,Fall,2011,8,0,0,0,Cloudy,0.676667,0.624388,0.8175,0.222633,1338,2482,3820,505,226,3820,2
227,2011-08-15,Fall,2011,8,0,1,1,Clear,0.665833,0.616167,0.712083,0.208954,775,3563,4338,504,227,4338,2
228,2011-08-16,Fall,2011,8,0,2,1,Clear,0.700833,0.645837,0.578333,0.236329,721,4004,4725,503,228,4725,2
229,2011-08-17,Fall,2011,8,0,3,1,Clear,0.723333,0.666671,0.575417,0.143667,668,4026,4694,502,229,4694,2
230,2011-08-18,Fall,2011,8,0,4,1,Clear,0.711667,0.662258,0.654583,0.233208,639,3166,3805,501,230,3805,2
231,2011-08-19,Fall,2011,8,0,5,1,Cloudy,0.685,0.633221,0.722917,0.139308,797,3356,4153,500,231,4153,2
232,2011-08-20,Fall,2011,8,0,6,0,Clear,0.6975,0.648996,0.674167,0.104467,1914,3277,5191,499,232,5191,2
233,2011-08-21,Fall,2011,8,0,0,0,Clear,0.710833,0.675525,0.77,0.248754,1249,2624,3873,498,233,3873,2
234,2011-08-22,Fall,2011,8,0,1,1,Clear,0.691667,0.638254,0.47,0.27675,833,3925,4758,497,234,4758,2
235,2011-08-23,Fall,2011,8,0,2,1,Clear,0.640833,0.606067,0.455417,0.146763,1281,4614,5895,496,235,5895,0
236,2011-08-24,Fall,2011,8,0,3,1,Clear,0.673333,0.630692,0.605,0.253108,949,4181,5130,495,236,5130,2
237,2011-08-25,Fall,2011,8,0,4,1,Cloudy,0.684167,0.645854,0.771667,0.210833,435,3107,3542,494,237,3542,2
238,2011-08-26,Fall,2011,8,0,5,1,Clear,0.7,0.659733,0.76125,0.0839625,768,3893,4661,493,238,4661,2
239,2011-08-27,Fall,2011,8,0,6,0,Cloudy,0.68,0.635556,0.85,0.375617,226,889,1115,492,239,1115,1
240,2011-08-28,Fall,2011,8,0,0,0,Clear,0.707059,0.647959,0.561765,0.304659,1415,2919,4334,491,240,4334,2
241,2011-08-29,Fall,2011,8,0,1,1,Clear,0.636667,0.607958,0.554583,0.159825,729,3905,4634,490,241,4634,2
242,2011-08-30,Fall,2011,8,0,2,1,Clear,0.639167,0.594704,0.548333,0.125008,775,4429,5204,489,242,5204,2
243,2011-08-31,Fall,2011,8,0,3,1,Clear,0.656667,0.611121,0.597917,0.0833333,688,4370,5058,488,243,5058,2
244,2011-09-01,Fall,2011,9,0,4,1,Clear,0.655,0.614921,0.639167,0.141796,783,4332,5115,487,244,5115,2
245,2011-09-02,Fall,2011,9,0,5,1,Cloudy,0.643333,0.604808,0.727083,0.139929,875,3852,4727,486,245,4727,2
246,2011-09-03,Fall,2011,9,0,6,0,Clear,0.669167,0.633213,0.716667,0.185325,1935,2549,4484,485,246,4484,2
247,2011-09-04,Fall,2011,9,0,0,0,Clear,0.709167,0.665429,0.742083,0.206467,2521,2419,4940,484,247,4940,2
248,2011-09-05,Fall,2011,9,1,1,0,Cloudy,0.673333,0.625646,0.790417,0.212696,1236,2115,3351,483,248,3351,2
249,2011-09-06,Fall,2011,9,0,2,1,Rain,0.54,0.5152,0.886957,0.343943,204,2506,2710,482,249,2710,1
250,2011-09-07,Fall,2011,9,0,3,1,Rain,0.599167,0.544229,0.917083,0.0970208,118,1878,1996,481,250,1996,1
251,2011-09-08,Fall,2011,9,0,4,1,Rain,0.633913,0.555361,0.939565,0.192748,153,1689,1842,480,251,1842,1
252,2011-09-09,Fall,2011,9,0,5,1,Cloudy,0.65,0.578946,0.897917,0.124379,417,3127,3544,479,252,3544,2
253,2011-09-10,Fall,2011,9,0,6,0,Clear,0.66,0.607962,0.75375,0.153608,1750,3595,5345,478,253,5345,2
254,2011-09-11,Fall,2011,9,0,0,0,Clear,0.653333,0.609229,0.71375,0.115054,1633,3413,5046,477,254,5046,2
255,2011-09-12,Fall,2011,9,0,1,1,Clear,0.644348,0.60213,0.692174,0.088913,690,4023,4713,476,255,4713,2
256,2011-09-13,Fall,2011,9,0,2,1,Clear,0.650833,0.603554,0.7125,0.141804,701,4062,4763,475,256,4763,2
257,2011-09-14,Fall,2011,9,0,3,1,Clear,0.673333,0.6269,0.697083,0.1673,647,4138,4785,474,257,4785,2
258,2011-09-15,Fall,2011,9,0,4,1,Cloudy,0.5775,0.553671,0.709167,0.271146,428,3231,3659,473,258,3659,2
259,2011-09-16,Fall,2011,9,0,5,1,Cloudy,0.469167,0.461475,0.590417,0.164183,742,4018,4760,472,259,4760,2
260,2011-09-17,Fall,2011,9,0,6,0,Cloudy,0.491667,0.478512,0.718333,0.189675,1434,3077,4511,471,260,4511,2
261,2011-09-18,Fall,2011,9,0,0,0,Clear,0.5075,0.490537,0.695,0.178483,1353,2921,4274,470,261,4274,2
262,2011-09-19,Fall,2011,9,0,1,1,Cloudy,0.549167,0.529675,0.69,0.151742,691,3848,4539,469,262,4539,2
263,2011-09-20,Fall,2011,9,0,2,1,Cloudy,0.561667,0.532217,0.88125,0.134954,438,3203,3641,468,263,3641,2
264,2011-09-21,Fall,2011,9,0,3,1,Cloudy,0.595,0.550533,0.9,0.0964042,539,3813,4352,467,264,4352,2
265,2011-09-22,Fall,2011,9,0,4,1,Cloudy,0.628333,0.554963,0.902083,0.128125,555,4240,4795,466,265,4795,2
266,2011-09-23,Winter,2011,9,0,5,1,Cloudy,0.609167,0.522125,0.9725,0.0783667,258,2137,2395,465,266,2395,1
267,2011-09-24,Winter,2011,9,0,6,0,Cloudy,0.606667,0.564412,0.8625,0.0783833,1776,3647,5423,464,267,5423,2
268,2011-09-25,Winter,2011,9,0,0,0,Cloudy,0.634167,0.572637,0.845,0.0503792,1544,3466,5010,463,268,5010,2
269,2011-09-26,Winter,2011,9,0,1,1,Cloudy,0.649167,0.589042,0.848333,0.1107,684,3946,4630,462,269,4630,2
270,2011-09-27,Winter,2011,9,0,2,1,Cloudy,0.636667,0.574525,0.885417,0.118171,477,3643,4120,461,270,4120,2
271,2011-09-28,Winter,2011,9,0,3,1,Cloudy,0.635,0.575158,0.84875,0.148629,480,3427,3907,460,271,3907,2
272,2011-09-29,Winter,2011,9,0,4,1,Clear,0.616667,0.574512,0.699167,0.172883,653,4186,4839,459,272,4839,2
273,2011-09-30,Winter,2011,9,0,5,1,Clear,0.564167,0.544829,0.6475,0.206475,830,4372,5202,458,273,5202,2
274,2011-10-01,Winter,2011,10,0,6,0,Cloudy,0.41,0.412863,0.75375,0.292296,480,1949,2429,457,274,2429,1
275,2011-10-02,Winter,2011,10,0,0,0,Cloudy,0.356667,0.345317,0.791667,0.222013,616,2302,2918,456,275,2918,1
276,2011-10-03,Winter,2011,10,0,1,1,Cloudy,0.384167,0.392046,0.760833,0.0833458,330,3240,3570,455,276,3570,2
277,2011-10-04,Winter,2011,10,0,2,1,Clear,0.484167,0.472858,0.71,0.205854,486,3970,4456,454,277,4456,2
278,2011-10-05,Winter,2011,10,0,3,1,Clear,0.538333,0.527138,0.647917,0.17725,559,4267,4826,453,278,4826,2
279,2011-10-06,Winter,2011,10,0,4,1,Clear,0.494167,0.480425,0.620833,0.134954,639,4126,4765,452,279,4765,2
280,2011-10-07,Winter,2011,10,0,5,1,Clear,0.510833,0.504404,0.684167,0.0223917,949,4036,4985,451,280,4985,2
281,2011-10-08,Winter,2011,10,0,6,0,Clear,0.521667,0.513242,0.70125,0.0454042,2235,3174,5409,450,281,5409,2
282,2011-10-09,Winter,2011,10,0,0,0,Clear,0.540833,0.523983,0.7275,0.06345,2397,3114,5511,449,282,5511,2
283,2011-10-10,Winter,2011,10,1,1,0,Clear,0.570833,0.542925,0.73375,0.0423042,1514,3603,5117,448,283,5117,2
284,2011-10-11,Winter,2011,10,0,2,1,Cloudy,0.566667,0.546096,0.80875,0.143042,667,3896,4563,447,284,4563,2
285,2011-10-12,Winter,2011,10,0,3,1,Rain,0.543333,0.517717,0.90625,0.24815,217,2199,2416,446,285,2416,1
286,2011-10-13,Winter,2011,10,0,4,1,Cloudy,0.589167,0.551804,0.896667,0.141787,290,2623,2913,445,286,2913,1
287,2011-10-14,Winter,2011,10,0,5,1,Cloudy,0.550833,0.529675,0.71625,0.223883,529,3115,3644,444,287,3644,2
288,2011-10-15,Winter,2011,10,0,6,0,Clear,0.506667,0.498725,0.483333,0.258083,1899,3318,5217,443,288,5217,2
289,2011-10-16,Winter,2011,10,0,0,0,Clear,0.511667,0.503154,0.486667,0.281717,1748,3293,5041,442,289,5041,2
290,2011-10-17,Winter,2011,10,0,1,1,Clear,0.534167,0.510725,0.579583,0.175379,713,3857,4570,441,290,4570,2
291,2011-10-18,Winter,2011,10,0,2,1,Cloudy,0.5325,0.522721,0.701667,0.110087,637,4111,4748,440,291,4748,2
292,2011-10-19,Winter,2011,10,0,3,1,Rain,0.541739,0.513848,0.895217,0.243339,254,2170,2424,439,292,2424,1
293,2011-10-20,Winter,2011,10,0,4,1,Clear,0.475833,0.466525,0.63625,0.422275,471,3724,4195,438,293,4195,2
294,2011-10-21,Winter,2011,10,0,5,1,Clear,0.4275,0.423596,0.574167,0.221396,676,3628,4304,437,294,4304,2
295,2011-10-22,Winter,2011,10,0,6,0,Clear,0.4225,0.425492,0.629167,0.0926667,1499,2809,4308,436,295,4308,2
296,2011-10-23,Winter,2011,10,0,0,0,Clear,0.421667,0.422333,0.74125,0.0995125,1619,2762,4381,435,296,4381,2
297,2011-10-24,Winter,2011,10,0,1,1,Clear,0.463333,0.457067,0.772083,0.118792,699,3488,4187,434,297,4187,2
298,2011-10-25,Winter,2011,10,0,2,1,Clear,0.471667,0.463375,0.622917,0.166658,695,3992,4687,433,298,4687,2
299,2011-10-26,Winter,2011,10,0,3,1,Cloudy,0.484167,0.472846,0.720417,0.148642,404,3490,3894,432,299,3894,2
300,2011-10-27,Winter,2011,10,0,4,1,Cloudy,0.47,0.457046,0.812917,0.197763,240,2419,2659,431,300,2659,1
301,2011-10-28,Winter,2011,10,0,5,1,Cloudy,0.330833,0.318812,0.585833,0.229479,456,3291,3747,430,301,3747,2
302,2011-10-29,Winter,2011,10,0,6,0,Rain,0.254167,0.227913,0.8825,0.351371,57,570,627,429,302,627,1
303,2011-10-30,Winter,2011,10,0,0,0,Clear,0.319167,0.321329,0.62375,0.176617,885,2446,3331,428,303,3331,2
304,2011-10-31,Winter,2011,10,0,1,1,Clear,0.34,0.356063,0.703333,0.10635,362,3307,3669,427,304,3669,2
305,2011-11-01,Winter,2011,11,0,2,1,Clear,0.400833,0.397088,0.68375,0.135571,410,3658,4068,426,305,4068,2
306,2011-11-02,Winter,2011,11,0,3,1,Clear,0.3775,0.390133,0.71875,0.0820917,370,3816,4186,425,306,4186,2
307,2011-11-03,Winter,2011,11,0,4,1,Clear,0.408333,0.405921,0.702083,0.136817,318,3656,3974,424,307,3974,2
308,2011-11-04,Winter,2011,11,0,5,1,Cloudy,0.403333,0.403392,0.6225,0.271779,470,3576,4046,423,308,4046,2
309,2011-11-05,Winter,2011,11,0,6,0,Clear,0.326667,0.323854,0.519167,0.189062,1156,2770,3926,422,309,3926,2
310,2011-11-06,Winter,2011,11,0,0,0,Clear,0.348333,0.362358,0.734583,0.0920542,952,2697,3649,421,310,3649,2
311,2011-11-07,Winter,2011,11,0,1,1,Clear,0.395,0.400871,0.75875,0.057225,373,3662,4035,420,311,4035,2
312,2011-11-08,Winter,2011,11,0,2,1,Clear,0.408333,0.412246,0.721667,0.0690375,376,3829,4205,419,312,4205,2
313,2011-11-09,Winter,2011,11,0,3,1,Clear,0.4,0.409079,0.758333,0.0621958,305,3804,4109,418,313,4109,2
314,2011-11-10,Winter,2011,11,0,4,1,Cloudy,0.38,0.373721,0.813333,0.189067,190,2743,2933,417,314,2933,1
315,2011-11-11,Winter,2011,11,1,5,0,Clear,0.324167,0.306817,0.44625,0.314675,440,2928,3368,416,315,3368,2
316,2011-11-12,Winter,2011,11,0,6,0,Clear,0.356667,0.357942,0.552917,0.212062,1275,2792,4067,415,316,4067,2
317,2011-11-13,Winter,2011,11,0,0,0,Clear,0.440833,0.43055,0.458333,0.281721,1004,2713,3717,414,317,3717,2
318,2011-11-14,Winter,2011,11,0,1,1,Clear,0.53,0.524612,0.587083,0.306596,595,3891,4486,413,318,4486,2
319,2011-11-15,Winter,2011,11,0,2,1,Cloudy,0.53,0.507579,0.68875,0.199633,449,3746,4195,412,319,4195,2
320,2011-11-16,Winter,2011,11,0,3,1,Rain,0.456667,0.451988,0.93,0.136829,145,1672,1817,411,320,1817,1
321,2011-11-17,Winter,2011,11,0,4,1,Cloudy,0.341667,0.323221,0.575833,0.305362,139,2914,3053,410,321,3053,1
322,2011-11-18,Winter,2011,11,0,5,1,Clear,0.274167,0.272721,0.41,0.168533,245,3147,3392,409,322,3392,2
323,2011-11-19,Winter,2011,11,0,6,0,Clear,0.329167,0.324483,0.502083,0.224496,943,2720,3663,408,323,3663,2
324,2011-11-20,Winter,2011,11,0,0,0,Cloudy,0.463333,0.457058,0.684583,0.18595,787,2733,3520,407,324,3520,2
325,2011-11-21,Winter,2011,11,0,1,1,Rain,0.4475,0.445062,0.91,0.138054,220,2545,2765,406,325,2765,1
326,2011-11-22,Winter,2011,11,0,2,1,Rain,0.416667,0.421696,0.9625,0.118792,69,1538,1607,405,326,1607,1
327,2011-11-23,Winter,2011,11,0,3,1,Cloudy,0.440833,0.430537,0.757917,0.335825,112,2454,2566,404,327,2566,1
328,2011-11-24,Winter,2011,11,1,4,0,Clear,0.373333,0.372471,0.549167,0.167304,560,935,1495,403,328,1495,1
329,2011-11-25,Winter,2011,11,0,5,1,Clear,0.375,0.380671,0.64375,0.0988958,1095,1697,2792,402,329,2792,1
330,2011-11-26,Winter,2011,11,0,6,0,Clear,0.375833,0.385087,0.681667,0.0684208,1249,1819,3068,401,330,3068,1
331,2011-11-27,Winter,2011,11,0,0,0,Clear,0.459167,0.4558,0.698333,0.208954,810,2261,3071,400,331,3071,1
332,2011-11-28,Winter,2011,11,0,1,1,Clear,0.503478,0.490122,0.743043,0.142122,253,3614,3867,399,332,3867,2
333,2011-11-29,Winter,2011,11,0,2,1,Cloudy,0.458333,0.451375,0.830833,0.258092,96,2818,2914,398,333,2914,1
334,2011-11-30,Winter,2011,11,0,3,1,Clear,0.325,0.311221,0.613333,0.271158,188,3425,3613,397,334,3613,2
335,2011-12-01,Winter,2011,12,0,4,1,Clear,0.3125,0.305554,0.524583,0.220158,182,3545,3727,396,335,3727,2
336,2011-12-02,Winter,2011,12,0,5,1,Clear,0.314167,0.331433,0.625833,0.100754,268,3672,3940,395,336,3940,2
337,2011-12-03,Winter,2011,12,0,6,0,Clear,0.299167,0.310604,0.612917,0.0957833,706,2908,3614,394,337,3614,2
338,2011-12-04,Winter,2011,12,0,0,0,Clear,0.330833,0.3491,0.775833,0.0839583,634,2851,3485,393,338,3485,2
339,2011-12-05,Winter,2011,12,0,1,1,Cloudy,0.385833,0.393925,0.827083,0.0622083,233,3578,3811,392,339,3811,2
340,2011-12-06,Winter,2011,12,0,2,1,Rain,0.4625,0.4564,0.949583,0.232583,126,2468,2594,391,340,2594,1
341,2011-12-07,Winter,2011,12,0,3,1,Rain,0.41,0.400246,0.970417,0.266175,50,655,705,390,341,705,1
342,2011-12-08,Winter,2011,12,0,4,1,Clear,0.265833,0.256938,0.58,0.240058,150,3172,3322,389,342,3322,2
343,2011-12-09,Winter,2011,12,0,5,1,Clear,0.290833,0.317542,0.695833,0.0827167,261,3359,3620,388,343,3620,2
344,2011-12-10,Winter,2011,12,0,6,0,Clear,0.275,0.266412,0.5075,0.233221,502,2688,3190,387,344,3190,2
345,2011-12-11,Winter,2011,12,0,0,0,Clear,0.220833,0.253154,0.49,0.0665417,377,2366,2743,386,345,2743,1
346,2011-12-12,Winter,2011,12,0,1,1,Clear,0.238333,0.270196,0.670833,0.06345,143,3167,3310,385,346,3310,2
347,2011-12-13,Winter,2011,12,0,2,1,Clear,0.2825,0.301138,0.59,0.14055,155,3368,3523,384,347,3523,2
348,2011-12-14,Winter,2011,12,0,3,1,Cloudy,0.3175,0.338362,0.66375,0.0609583,178,3562,3740,383,348,3740,2
349,2011-12-15,Winter,2011,12,0,4,1,Cloudy,0.4225,0.412237,0.634167,0.268042,181,3528,3709,382,349,3709,2
350,2011-12-16,Winter,2011,12,0,5,1,Cloudy,0.375,0.359825,0.500417,0.260575,178,3399,3577,381,350,3577,2
351,2011-12-17,Winter,2011,12,0,6,0,Cloudy,0.258333,0.249371,0.560833,0.243167,275,2464,2739,380,351,2739,1
352,2011-12-18,Winter,2011,12,0,0,0,Clear,0.238333,0.245579,0.58625,0.169779,220,2211,2431,379,352,2431,1
353,2011-12-19,Winter,2011,12,0,1,1,Clear,0.276667,0.280933,0.6375,0.172896,260,3143,3403,378,353,3403,2
354,2011-12-20,Winter,2011,12,0,2,1,Cloudy,0.385833,0.396454,0.595417,0.0615708,216,3534,3750,377,354,3750,2
355,2011-12-21,Spring,2011,12,0,3,1,Cloudy,0.428333,0.428017,0.858333,0.2214,107,2553,2660,376,355,2660,1
356,2011-12-22,Spring,2011,12,0,4,1,Cloudy,0.423333,0.426121,0.7575,0.047275,227,2841,3068,375,356,3068,1
357,2011-12-23,Spring,2011,12,0,5,1,Clear,0.373333,0.377513,0.68625,0.274246,163,2046,2209,374,357,2209,1
358,2011-12-24,Spring,2011,12,0,6,0,Clear,0.3025,0.299242,0.5425,0.190304,155,856,1011,373,358,1011,1
359,2011-12-25,Spring,2011,12,0,0,0,Clear,0.274783,0.279961,0.681304,0.155091,303,451,754,372,359,754,1
360,2011-12-26,Spring,2011,12,1,1,0,Clear,0.321739,0.315535,0.506957,0.239465,430,887,1317,371,360,1317,1
361,2011-12-27,Spring,2011,12,0,2,1,Cloudy,0.325,0.327633,0.7625,0.18845,103,1059,1162,370,361,1162,1
362,2011-12-28,Spring,2011,12,0,3,1,Clear,0.29913,0.279974,0.503913,0.293961,255,2047,2302,369,362,2302,1
363,2011-12-29,Spring,2011,12,0,4,1,Clear,0.248333,0.263892,0.574167,0.119412,254,2169,2423,368,363,2423,1
364,2011-12-30,Spring,2011,12,0,5,1,Clear,0.311667,0.318812,0.636667,0.134337,491,2508,2999,367,364,2999,1
365,2011-12-31,Spring,2011,12,0,6,0,Clear,0.41,0.414121,0.615833,0.220154,665,1820,2485,366,365,2485,1
366,2012-01-01,Spring,2012,1,0,0,0,Clear,0.37,0.375621,0.6925,0.192167,686,1608,2294,365,366,2294,1
367,2012-01-02,Spring,2012,1,1,1,0,Clear,0.273043,0.252304,0.381304,0.329665,244,1707,1951,364,367,1951,1
368,2012-01-03,Spring,2012,1,0,2,1,Clear,0.15,0.126275,0.44125,0.365671,89,2147,2236,363,368,2236,1
369,2012-01-04,Spring,2012,1,0,3,1,Cloudy,0.1075,0.119337,0.414583,0.1847,95,2273,2368,362,369,2368,1
370,2012-01-05,Spring,2012,1,0,4,1,Clear,0.265833,0.278412,0.524167,0.129987,140,3132,3272,361,370,3272,2
371,2012-01-06,Spring,2012,1,0,5,1,Clear,0.334167,0.340267,0.542083,0.167908,307,3791,4098,360,371,4098,2
372,2012-01-07,Spring,2012,1,0,6,0,Clear,0.393333,0.390779,0.531667,0.174758,1070,3451,4521,359,372,4521,2
373,2012-01-08,Spring,2012,1,0,0,0,Clear,0.3375,0.340258,0.465,0.191542,599,2826,3425,358,373,3425,2
374,2012-01-09,Spring,2012,1,0,1,1,Cloudy,0.224167,0.247479,0.701667,0.0989,106,2270,2376,357,374,2376,1
375,2012-01-10,Spring,2012,1,0,2,1,Clear,0.308696,0.318826,0.646522,0.187552,173,3425,3598,356,375,3598,2
376,2012-01-11,Spring,2012,1,0,3,1,Cloudy,0.274167,0.282821,0.8475,0.131221,92,2085,2177,355,376,2177,1
377,2012-01-12,Spring,2012,1,0,4,1,Cloudy,0.3825,0.381938,0.802917,0.180967,269,3828,4097,354,377,4097,2
378,2012-01-13,Spring,2012,1,0,5,1,Clear,0.274167,0.249362,0.5075,0.378108,174,3040,3214,353,378,3214,2
379,2012-01-14,Spring,2012,1,0,6,0,Clear,0.18,0.183087,0.4575,0.187183,333,2160,2493,352,379,2493,1
380,2012-01-15,Spring,2012,1,0,0,0,Clear,0.166667,0.161625,0.419167,0.251258,284,2027,2311,351,380,2311,1
381,2012-01-16,Spring,2012,1,1,1,0,Clear,0.19,0.190663,0.5225,0.231358,217,2081,2298,350,381,2298,1
382,2012-01-17,Spring,2012,1,0,2,1,Cloudy,0.373043,0.364278,0.716087,0.34913,127,2808,2935,349,382,2935,1
383,2012-01-18,Spring,2012,1,0,3,1,Clear,0.303333,0.275254,0.443333,0.415429,109,3267,3376,348,383,3376,2
384,2012-01-19,Spring,2012,1,0,4,1,Clear,0.19,0.190038,0.4975,0.220158,130,3162,3292,347,384,3292,2
385,2012-01-20,Spring,2012,1,0,5,1,Cloudy,0.2175,0.220958,0.45,0.20275,115,3048,3163,346,385,3163,1
386,2012-01-21,Spring,2012,1,0,6,0,Cloudy,0.173333,0.174875,0.83125,0.222642,67,1234,1301,345,386,1301,1
387,2012-01-22,Spring,2012,1,0,0,0,Cloudy,0.1625,0.16225,0.79625,0.199638,196,1781,1977,344,387,1977,1
388,2012-01-23,Spring,2012,1,0,1,1,Cloudy,0.218333,0.243058,0.91125,0.110708,145,2287,2432,343,388,2432,1
389,2012-01-24,Spring,2012,1,0,2,1,Clear,0.3425,0.349108,0.835833,0.123767,439,3900,4339,342,389,4339,2
390,2012-01-25,Spring,2012,1,0,3,1,Clear,0.294167,0.294821,0.64375,0.161071,467,3803,4270,341,390,4270,2
391,2012-01-26,Spring,2012,1,0,4,1,Cloudy,0.341667,0.35605,0.769583,0.0733958,244,3831,4075,340,391,4075,2
392,2012-01-27,Spring,2012,1,0,5,1,Cloudy,0.425,0.415383,0.74125,0.342667,269,3187,3456,339,392,3456,2
393,2012-01-28,Spring,2012,1,0,6,0,Clear,0.315833,0.326379,0.543333,0.210829,775,3248,4023,338,393,4023,2
394,2012-01-29,Spring,2012,1,0,0,0,Clear,0.2825,0.272721,0.31125,0.24005,558,2685,3243,337,394,3243,2
395,2012-01-30,Spring,2012,1,0,1,1,Clear,0.269167,0.262625,0.400833,0.215792,126,3498,3624,336,395,3624,2
396,2012-01-31,Spring,2012,1,0,2,1,Clear,0.39,0.381317,0.416667,0.261817,324,4185,4509,335,396,4509,2
397,2012-02-01,Spring,2012,2,0,3,1,Clear,0.469167,0.466538,0.507917,0.189067,304,4275,4579,334,397,4579,2
398,2012-02-02,Spring,2012,2,0,4,1,Cloudy,0.399167,0.398971,0.672917,0.187187,190,3571,3761,333,398,3761,2
399,2012-02-03,Spring,2012,2,0,5,1,Clear,0.313333,0.309346,0.526667,0.178496,310,3841,4151,332,399,4151,2
400,2012-02-04,Spring,2012,2,0,6,0,Cloudy,0.264167,0.272725,0.779583,0.121896,384,2448,2832,331,400,2832,1
401,2012-02-05,Spring,2012,2,0,0,0,Cloudy,0.265833,0.264521,0.687917,0.175996,318,2629,2947,330,401,2947,1
402,2012-02-06,Spring,2012,2,0,1,1,Clear,0.282609,0.296426,0.622174,0.1538,206,3578,3784,329,402,3784,2
403,2012-02-07,Spring,2012,2,0,2,1,Clear,0.354167,0.361104,0.49625,0.147379,199,4176,4375,328,403,4375,2
404,2012-02-08,Spring,2012,2,0,3,1,Cloudy,0.256667,0.266421,0.722917,0.133721,109,2693,2802,327,404,2802,1
405,2012-02-09,Spring,2012,2,0,4,1,Clear,0.265,0.261988,0.562083,0.194037,163,3667,3830,326,405,3830,2
406,2012-02-10,Spring,2012,2,0,5,1,Cloudy,0.280833,0.293558,0.54,0.116929,227,3604,3831,325,406,3831,2
407,2012-02-11,Spring,2012,2,0,6,0,Rain,0.224167,0.210867,0.73125,0.289796,192,1977,2169,324,407,2169,1
408,2012-02-12,Spring,2012,2,0,0,0,Clear,0.1275,0.101658,0.464583,0.409212,73,1456,1529,323,408,1529,1
409,2012-02-13,Spring,2012,2,0,1,1,Clear,0.2225,0.227913,0.41125,0.167283,94,3328,3422,322,409,3422,2
410,2012-02-14,Spring,2012,2,0,2,1,Cloudy,0.319167,0.333946,0.50875,0.141179,135,3787,3922,321,410,3922,2
411,2012-02-15,Spring,2012,2,0,3,1,Clear,0.348333,0.351629,0.53125,0.1816,141,4028,4169,320,411,4169,2
412,2012-02-16,Spring,2012,2,0,4,1,Cloudy,0.316667,0.330162,0.752917,0.091425,74,2931,3005,319,412,3005,1
413,2012-02-17,Spring,2012,2,0,5,1,Clear,0.343333,0.351629,0.634583,0.205846,349,3805,4154,318,413,4154,2
414,2012-02-18,Spring,2012,2,0,6,0,Clear,0.346667,0.355425,0.534583,0.190929,1435,2883,4318,317,414,4318,2
415,2012-02-19,Spring,2012,2,0,0,0,Cloudy,0.28,0.265788,0.515833,0.253112,618,2071,2689,316,415,2689,1
416,2012-02-20,Spring,2012,2,1,1,0,Clear,0.28,0.273391,0.507826,0.229083,502,2627,3129,315,416,3129,1
417,2012-02-21,Spring,2012,2,0,2,1,Clear,0.287826,0.295113,0.594348,0.205717,163,3614,3777,314,417,3777,2
418,2012-02-22,Spring,2012,2,0,3,1,Clear,0.395833,0.392667,0.567917,0.234471,394,4379,4773,313,418,4773,2
419,2012-02-23,Spring,2012,2,0,4,1,Clear,0.454167,0.444446,0.554583,0.190913,516,4546,5062,312,419,5062,2
420,2012-02-24,Spring,2012,2,0,5,1,Cloudy,0.4075,0.410971,0.7375,0.237567,246,3241,3487,311,420,3487,2
421,2012-02-25,Spring,2012,2,0,6,0,Clear,0.290833,0.255675,0.395833,0.421642,317,2415,2732,310,421,2732,1
422,2012-02-26,Spring,2012,2,0,0,0,Clear,0.279167,0.268308,0.41,0.205229,515,2874,3389,309,422,3389,2
423,2012-02-27,Spring,2012,2,0,1,1,Clear,0.366667,0.357954,0.490833,0.268033,253,4069,4322,308,423,4322,2
424,2012-02-28,Spring,2012,2,0,2,1,Clear,0.359167,0.353525,0.395833,0.193417,229,4134,4363,307,424,4363,2
425,2012-02-29,Spring,2012,2,0,3,1,Cloudy,0.344348,0.34847,0.804783,0.179117,65,1769,1834,306,425,1834,1
426,2012-03-01,Spring,2012,3,0,4,1,Clear,0.485833,0.475371,0.615417,0.226987,325,4665,4990,305,426,4990,2
427,2012-03-02,Spring,2012,3,0,5,1,Cloudy,0.353333,0.359842,0.657083,0.144904,246,2948,3194,304,427,3194,2
428,2012-03-03,Spring,2012,3,0,6,0,Cloudy,0.414167,0.413492,0.62125,0.161079,956,3110,4066,303,428,4066,2
429,2012-03-04,Spring,2012,3,0,0,0,Clear,0.325833,0.303021,0.403333,0.334571,710,2713,3423,302,429,3423,2
430,2012-03-05,Spring,2012,3,0,1,1,Clear,0.243333,0.241171,0.50625,0.228858,203,3130,3333,301,430,3333,2
431,2012-03-06,Spring,2012,3,0,2,1,Clear,0.258333,0.255042,0.456667,0.200875,221,3735,3956,300,431,3956,2
432,2012-03-07,Spring,2012,3,0,3,1,Clear,0.404167,0.3851,0.513333,0.345779,432,4484,4916,299,432,4916,2
433,2012-03-08,Spring,2012,3,0,4,1,Clear,0.5275,0.524604,0.5675,0.441563,486,4896,5382,298,433,5382,2
434,2012-03-09,Spring,2012,3,0,5,1,Cloudy,0.410833,0.397083,0.407083,0.4148,447,4122,4569,297,434,4569,2
435,2012-03-10,Spring,2012,3,0,6,0,Clear,0.2875,0.277767,0.350417,0.22575,968,3150,4118,296,435,4118,2
436,2012-03-11,Spring,2012,3,0,0,0,Clear,0.361739,0.35967,0.476957,0.222587,1658,3253,4911,295,436,4911,2
437,2012-03-12,Spring,2012,3,0,1,1,Clear,0.466667,0.459592,0.489167,0.207713,838,4460,5298,294,437,5298,2
438,2012-03-13,Spring,2012,3,0,2,1,Clear,0.565,0.542929,0.6175,0.23695,762,5085,5847,293,438,5847,0
439,2012-03-14,Spring,2012,3,0,3,1,Clear,0.5725,0.548617,0.507083,0.115062,997,5315,6312,292,439,6312,0
440,2012-03-15,Spring,2012,3,0,4,1,Clear,0.5575,0.532825,0.579583,0.149883,1005,5187,6192,291,440,6192,0
441,2012-03-16,Spring,2012,3,0,5,1,Cloudy,0.435833,0.436229,0.842083,0.113192,548,3830,4378,290,441,4378,2
442,2012-03-17,Spring,2012,3,0,6,0,Cloudy,0.514167,0.505046,0.755833,0.110704,3155,4681,7836,289,442,7836,0
443,2012-03-18,Spring,2012,3,0,0,0,Cloudy,0.4725,0.464,0.81,0.126883,2207,3685,5892,288,443,5892,0
444,2012-03-19,Spring,2012,3,0,1,1,Clear,0.545,0.532821,0.72875,0.162317,982,5171,6153,287,444,6153,0
445,2012-03-20,Spring,2012,3,0,2,1,Clear,0.560833,0.538533,0.807917,0.121271,1051,5042,6093,286,445,6093,0
446,2012-03-21,Summer,2012,3,0,3,1,Cloudy,0.531667,0.513258,0.82125,0.0895583,1122,5108,6230,285,446,6230,0
447,2012-03-22,Summer,2012,3,0,4,1,Clear,0.554167,0.531567,0.83125,0.117562,1334,5537,6871,284,447,6871,0
448,2012-03-23,Summer,2012,3,0,5,1,Cloudy,0.601667,0.570067,0.694167,0.1163,2469,5893,8362,283,448,8362,0
449,2012-03-24,Summer,2012,3,0,6,0,Cloudy,0.5025,0.486733,0.885417,0.192783,1033,2339,3372,282,449,3372,2
450,2012-03-25,Summer,2012,3,0,0,0,Cloudy,0.4375,0.437488,0.880833,0.220775,1532,3464,4996,281,450,4996,2
451,2012-03-26,Summer,2012,3,0,1,1,Clear,0.445833,0.43875,0.477917,0.386821,795,4763,5558,280,451,5558,2
452,2012-03-27,Summer,2012,3,0,2,1,Clear,0.323333,0.315654,0.29,0.187192,531,4571,5102,279,452,5102,2
453,2012-03-28,Summer,2012,3,0,3,1,Clear,0.484167,0.47095,0.48125,0.291671,674,5024,5698,278,453,5698,0
454,2012-03-29,Summer,2012,3,0,4,1,Clear,0.494167,0.482304,0.439167,0.31965,834,5299,6133,277,454,6133,0
455,2012-03-30,Summer,2012,3,0,5,1,Cloudy,0.37,0.375621,0.580833,0.138067,796,4663,5459,276,455,5459,2
456,2012-03-31,Summer,2012,3,0,6,0,Cloudy,0.424167,0.421708,0.738333,0.250617,2301,3934,6235,275,456,6235,0
457,2012-04-01,Summer,2012,4,0,0,0,Cloudy,0.425833,0.417287,0.67625,0.172267,2347,3694,6041,274,457,6041,0
458,2012-04-02,Summer,2012,4,0,1,1,Clear,0.433913,0.427513,0.504348,0.312139,1208,4728,5936,273,458,5936,0
459,2012-04-03,Summer,2012,4,0,2,1,Clear,0.466667,0.461483,0.396667,0.100133,1348,5424,6772,272,459,6772,0
460,2012-04-04,Summer,2012,4,0,3,1,Clear,0.541667,0.53345,0.469583,0.180975,1058,5378,6436,271,460,6436,0
461,2012-04-05,Summer,2012,4,0,4,1,Clear,0.435,0.431163,0.374167,0.219529,1192,5265,6457,270,461,6457,0
462,2012-04-06,Summer,2012,4,0,5,1,Clear,0.403333,0.390767,0.377083,0.300388,1807,4653,6460,269,462,6460,0
463,2012-04-07,Summer,2012,4,0,6,0,Clear,0.4375,0.426129,0.254167,0.274871,3252,3605,6857,268,463,6857,0
464,2012-04-08,Summer,2012,4,0,0,0,Clear,0.5,0.492425,0.275833,0.232596,2230,2939,5169,267,464,5169,2
465,2012-04-09,Summer,2012,4,0,1,1,Clear,0.489167,0.476638,0.3175,0.358196,905,4680,5585,266,465,5585,2
466,2012-04-10,Summer,2012,4,0,2,1,Clear,0.446667,0.436233,0.435,0.249375,819,5099,5918,265,466,5918,0
467,2012-04-11,Summer,2012,4,0,3,1,Clear,0.348696,0.337274,0.469565,0.295274,482,4380,4862,264,467,4862,2
468,2012-04-12,Summer,2012,4,0,4,1,Clear,0.3975,0.387604,0.46625,0.290429,663,4746,5409,263,468,5409,2
469,2012-04-13,Summer,2012,4,0,5,1,Clear,0.4425,0.431808,0.408333,0.155471,1252,5146,6398,262,469,6398,0
470,2012-04-14,Summer,2012,4,0,6,0,Clear,0.495,0.487996,0.502917,0.190917,2795,4665,7460,261,470,7460,0
471,2012-04-15,Summer,2012,4,0,0,0,Clear,0.606667,0.573875,0.507917,0.225129,2846,4286,7132,260,471,7132,0
472,2012-04-16,Summer,2012,4,1,1,0,Clear,0.664167,0.614925,0.561667,0.284829,1198,5172,6370,259,472,6370,0
473,2012-04-17,Summer,2012,4,0,2,1,Clear,0.608333,0.598487,0.390417,0.273629,989,5702,6691,258,473,6691,0
474,2012-04-18,Summer,2012,4,0,3,1,Cloudy,0.463333,0.457038,0.569167,0.167912,347,4020,4367,257,474,4367,2
475,2012-04-19,Summer,2012,4,0,4,1,Clear,0.498333,0.493046,0.6125,0.0659292,846,5719,6565,256,475,6565,0
476,2012-04-20,Summer,2012,4,0,5,1,Clear,0.526667,0.515775,0.694583,0.149871,1340,5950,7290,255,476,7290,0
477,2012-04-21,Summer,2012,4,0,6,0,Clear,0.57,0.542921,0.682917,0.283587,2541,4083,6624,254,477,6624,0
478,2012-04-22,Summer,2012,4,0,0,0,Rain,0.396667,0.389504,0.835417,0.344546,120,907,1027,253,478,1027,1
479,2012-04-23,Summer,2012,4,0,1,1,Cloudy,0.321667,0.301125,0.766667,0.303496,195,3019,3214,252,479,3214,2
480,2012-04-24,Summer,2012,4,0,2,1,Clear,0.413333,0.405283,0.454167,0.249383,518,5115,5633,251,480,5633,2
481,2012-04-25,Summer,2012,4,0,3,1,Clear,0.476667,0.470317,0.427917,0.118792,655,5541,6196,250,481,6196,0
482,2012-04-26,Summer,2012,4,0,4,1,Cloudy,0.498333,0.483583,0.756667,0.176625,475,4551,5026,249,482,5026,2
483,2012-04-27,Summer,2012,4,0,5,1,Clear,0.4575,0.452637,0.400833,0.347633,1014,5219,6233,248,483,6233,0
484,2012-04-28,Summer,2012,4,0,6,0,Cloudy,0.376667,0.377504,0.489583,0.129975,1120,3100,4220,247,484,4220,2
485,2012-04-29,Summer,2012,4,0,0,0,Clear,0.458333,0.450121,0.587083,0.116908,2229,4075,6304,246,485,6304,0
486,2012-04-30,Summer,2012,4,0,1,1,Cloudy,0.464167,0.457696,0.57,0.171638,665,4907,5572,245,486,5572,2
487,2012-05-01,Summer,2012,5,0,2,1,Cloudy,0.613333,0.577021,0.659583,0.156096,653,5087,5740,244,487,5740,0
488,2012-05-02,Summer,2012,5,0,3,1,Clear,0.564167,0.537896,0.797083,0.138058,667,5502,6169,243,488,6169,0
489,2012-05-03,Summer,2012,5,0,4,1,Cloudy,0.56,0.537242,0.768333,0.133696,764,5657,6421,242,489,6421,0
490,2012-05-04,Summer,2012,5,0,5,1,Clear,0.6275,0.590917,0.735417,0.162938,1069,5227,6296,241,490,6296,0
491,2012-05-05,Summer,2012,5,0,6,0,Cloudy,0.621667,0.584608,0.756667,0.152992,2496,4387,6883,240,491,6883,0
492,2012-05-06,Summer,2012,5,0,0,0,Cloudy,0.5625,0.546737,0.74,0.149879,2135,4224,6359,239,492,6359,0
493,2012-05-07,Summer,2012,5,0,1,1,Cloudy,0.5375,0.527142,0.664167,0.230721,1008,5265,6273,238,493,6273,0
494,2012-05-08,Summer,2012,5,0,2,1,Cloudy,0.581667,0.557471,0.685833,0.296029,738,4990,5728,237,494,5728,0
495,2012-05-09,Summer,2012,5,0,3,1,Cloudy,0.575,0.553025,0.744167,0.216412,620,4097,4717,236,495,4717,2
496,2012-05-10,Summer,2012,5,0,4,1,Clear,0.505833,0.491783,0.552083,0.314063,1026,5546,6572,235,496,6572,0
497,2012-05-11,Summer,2012,5,0,5,1,Clear,0.533333,0.520833,0.360417,0.236937,1319,5711,7030,234,497,7030,0
498,2012-05-12,Summer,2012,5,0,6,0,Clear,0.564167,0.544817,0.480417,0.123133,2622,4807,7429,233,498,7429,0
499,2012-05-13,Summer,2012,5,0,0,0,Clear,0.6125,0.585238,0.57625,0.225117,2172,3946,6118,232,499,6118,0
500,2012-05-14,Summer,2012,5,0,1,1,Cloudy,0.573333,0.5499,0.789583,0.212692,342,2501,2843,231,500,2843,1
501,2012-05-15,Summer,2012,5,0,2,1,Cloudy,0.611667,0.576404,0.794583,0.147392,625,4490,5115,230,501,5115,2
502,2012-05-16,Summer,2012,5,0,3,1,Clear,0.636667,0.595975,0.697917,0.122512,991,6433,7424,229,502,7424,0
503,2012-05-17,Summer,2012,5,0,4,1,Clear,0.593333,0.572613,0.52,0.229475,1242,6142,7384,228,503,7384,0
504,2012-05-18,Summer,2012,5,0,5,1,Clear,0.564167,0.551121,0.523333,0.136817,1521,6118,7639,227,504,7639,0
505,2012-05-19,Summer,2012,5,0,6,0,Clear,0.6,0.566908,0.45625,0.083975,3410,4884,8294,226,505,8294,0
506,2012-05-20,Summer,2012,5,0,0,0,Clear,0.620833,0.583967,0.530417,0.254367,2704,4425,7129,225,506,7129,0
507,2012-05-21,Summer,2012,5,0,1,1,Cloudy,0.598333,0.565667,0.81125,0.233204,630,3729,4359,224,507,4359,2
508,2012-05-22,Summer,2012,5,0,2,1,Cloudy,0.615,0.580825,0.765833,0.118167,819,5254,6073,223,508,6073,0
509,2012-05-23,Summer,2012,5,0,3,1,Cloudy,0.621667,0.584612,0.774583,0.102,766,4494,5260,222,509,5260,2
510,2012-05-24,Summer,2012,5,0,4,1,Clear,0.655,0.6067,0.716667,0.172896,1059,5711,6770,221,510,6770,0
511,2012-05-25,Summer,2012,5,0,5,1,Clear,0.68,0.627529,0.747083,0.14055,1417,5317,6734,220,511,6734,0
512,2012-05-26,Summer,2012,5,0,6,0,Clear,0.6925,0.642696,0.7325,0.198992,2855,3681,6536,219,512,6536,0
513,2012-05-27,Summer,2012,5,0,0,0,Clear,0.69,0.641425,0.697083,0.215171,3283,3308,6591,218,513,6591,0
514,2012-05-28,Summer,2012,5,1,1,0,Clear,0.7125,0.6793,0.67625,0.196521,2557,3486,6043,217,514,6043,0
515,2012-05-29,Summer,2012,5,0,2,1,Clear,0.7225,0.672992,0.684583,0.2954,880,4863,5743,216,515,5743,0
516,2012-05-30,Summer,2012,5,0,3,1,Cloudy,0.656667,0.611129,0.67,0.134329,745,6110,6855,215,516,6855,0
517,2012-05-31,Summer,2012,5,0,4,1,Clear,0.68,0.631329,0.492917,0.195279,1100,6238,7338,214,517,7338,0
518,2012-06-01,Summer,2012,6,0,5,1,Cloudy,0.654167,0.607962,0.755417,0.237563,533,3594,4127,213,518,4127,2
519,2012-06-02,Summer,2012,6,0,6,0,Clear,0.583333,0.566288,0.549167,0.186562,2795,5325,8120,212,519,8120,0
520,2012-06-03,Summer,2012,6,0,0,0,Clear,0.6025,0.575133,0.493333,0.184087,2494,5147,7641,211,520,7641,0
521,2012-06-04,Summer,2012,6,0,1,1,Clear,0.5975,0.578283,0.487083,0.284833,1071,5927,6998,210,521,6998,0
522,2012-06-05,Summer,2012,6,0,2,1,Cloudy,0.540833,0.525892,0.613333,0.209575,968,6033,7001,209,522,7001,0
523,2012-06-06,Summer,2012,6,0,3,1,Clear,0.554167,0.542292,0.61125,0.077125,1027,6028,7055,208,523,7055,0
524,2012-06-07,Summer,2012,6,0,4,1,Clear,0.6025,0.569442,0.567083,0.15735,1038,6456,7494,207,524,7494,0
525,2012-06-08,Summer,2012,6,0,5,1,Clear,0.649167,0.597862,0.467917,0.175383,1488,6248,7736,206,525,7736,0
526,2012-06-09,Summer,2012,6,0,6,0,Clear,0.710833,0.648367,0.437083,0.144287,2708,4790,7498,205,526,7498,0
527,2012-06-10,Summer,2012,6,0,0,0,Clear,0.726667,0.663517,0.538333,0.133721,2224,4374,6598,204,527,6598,0
528,2012-06-11,Summer,2012,6,0,1,1,Cloudy,0.720833,0.659721,0.587917,0.207713,1017,5647,6664,203,528,6664,0
529,2012-06-12,Summer,2012,6,0,2,1,Cloudy,0.653333,0.597875,0.833333,0.214546,477,4495,4972,202,529,4972,2
530,2012-06-13,Summer,2012,6,0,3,1,Clear,0.655833,0.611117,0.582083,0.343279,1173,6248,7421,201,530,7421,0
531,2012-06-14,Summer,2012,6,0,4,1,Clear,0.648333,0.624383,0.569583,0.253733,1180,6183,7363,200,531,7363,0
532,2012-06-15,Summer,2012,6,0,5,1,Clear,0.639167,0.599754,0.589583,0.176617,1563,6102,7665,199,532,7665,0
533,2012-06-16,Summer,2012,6,0,6,0,Clear,0.631667,0.594708,0.504167,0.166667,2963,4739,7702,198,533,7702,0
534,2012-06-17,Summer,2012,6,0,0,0,Clear,0.5925,0.571975,0.59875,0.144904,2634,4344,6978,197,534,6978,0
535,2012-06-18,Summer,2012,6,0,1,1,Cloudy,0.568333,0.544842,0.777917,0.174746,653,4446,5099,196,535,5099,2
536,2012-06-19,Summer,2012,6,0,2,1,Clear,0.688333,0.654692,0.69,0.148017,968,5857,6825,195,536,6825,0
537,2012-06-20,Summer,2012,6,0,3,1,Clear,0.7825,0.720975,0.592083,0.113812,872,5339,6211,194,537,6211,0
538,2012-06-21,Fall,2012,6,0,4,1,Clear,0.805833,0.752542,0.567917,0.118787,778,5127,5905,193,538,5905,0
539,2012-06-22,Fall,2012,6,0,5,1,Clear,0.7775,0.724121,0.57375,0.182842,964,4859,5823,192,539,5823,0
540,2012-06-23,Fall,2012,6,0,6,0,Clear,0.731667,0.652792,0.534583,0.179721,2657,4801,7458,191,540,7458,0
541,2012-06-24,Fall,2012,6,0,0,0,Clear,0.743333,0.674254,0.479167,0.145525,2551,4340,6891,190,541,6891,0
542,2012-06-25,Fall,2012,6,0,1,1,Clear,0.715833,0.654042,0.504167,0.300383,1139,5640,6779,189,542,6779,0
543,2012-06-26,Fall,2012,6,0,2,1,Clear,0.630833,0.594704,0.373333,0.347642,1077,6365,7442,188,543,7442,0
544,2012-06-27,Fall,2012,6,0,3,1,Clear,0.6975,0.640792,0.36,0.271775,1077,6258,7335,187,544,7335,0
545,2012-06-28,Fall,2012,6,0,4,1,Clear,0.749167,0.675512,0.4225,0.17165,921,5958,6879,186,545,6879,0
546,2012-06-29,Fall,2012,6,0,5,1,Clear,0.834167,0.786613,0.48875,0.165417,829,4634,5463,185,546,5463,2
547,2012-06-30,Fall,2012,6,0,6,0,Clear,0.765,0.687508,0.60125,0.161071,1455,4232,5687,184,547,5687,0
548,2012-07-01,Fall,2012,7,0,0,0,Clear,0.815833,0.750629,0.51875,0.168529,1421,4110,5531,183,548,5531,2
549,2012-07-02,Fall,2012,7,0,1,1,Clear,0.781667,0.702038,0.447083,0.195267,904,5323,6227,182,549,6227,0
550,2012-07-03,Fall,2012,7,0,2,1,Clear,0.780833,0.70265,0.492083,0.126237,1052,5608,6660,181,550,6660,0
551,2012-07-04,Fall,2012,7,1,3,0,Clear,0.789167,0.732337,0.53875,0.13495,2562,4841,7403,180,551,7403,0
552,2012-07-05,Fall,2012,7,0,4,1,Clear,0.8275,0.761367,0.457917,0.194029,1405,4836,6241,179,552,6241,0
553,2012-07-06,Fall,2012,7,0,5,1,Clear,0.828333,0.752533,0.450833,0.146142,1366,4841,6207,178,553,6207,0
554,2012-07-07,Fall,2012,7,0,6,0,Clear,0.861667,0.804913,0.492083,0.163554,1448,3392,4840,177,554,4840,2
555,2012-07-08,Fall,2012,7,0,0,0,Clear,0.8225,0.790396,0.57375,0.125629,1203,3469,4672,176,555,4672,2
556,2012-07-09,Fall,2012,7,0,1,1,Cloudy,0.710833,0.654054,0.683333,0.180975,998,5571,6569,175,556,6569,0
557,2012-07-10,Fall,2012,7,0,2,1,Cloudy,0.720833,0.664796,0.6675,0.151737,954,5336,6290,174,557,6290,0
558,2012-07-11,Fall,2012,7,0,3,1,Clear,0.716667,0.650271,0.633333,0.151733,975,6289,7264,173,558,7264,0
559,2012-07-12,Fall,2012,7,0,4,1,Clear,0.715833,0.654683,0.529583,0.146775,1032,6414,7446,172,559,7446,0
560,2012-07-13,Fall,2012,7,0,5,1,Cloudy,0.731667,0.667933,0.485833,0.08085,1511,5988,7499,171,560,7499,0
561,2012-07-14,Fall,2012,7,0,6,0,Cloudy,0.703333,0.666042,0.699167,0.143679,2355,4614,6969,170,561,6969,0
562,2012-07-15,Fall,2012,7,0,0,0,Clear,0.745833,0.705196,0.717917,0.166667,1920,4111,6031,169,562,6031,0
563,2012-07-16,Fall,2012,7,0,1,1,Clear,0.763333,0.724125,0.645,0.164187,1088,5742,6830,168,563,6830,0
564,2012-07-17,Fall,2012,7,0,2,1,Clear,0.818333,0.755683,0.505833,0.114429,921,5865,6786,167,564,6786,0
565,2012-07-18,Fall,2012,7,0,3,1,Clear,0.793333,0.745583,0.577083,0.137442,799,4914,5713,166,565,5713,0
566,2012-07-19,Fall,2012,7,0,4,1,Clear,0.77,0.714642,0.600417,0.165429,888,5703,6591,165,566,6591,0
567,2012-07-20,Fall,2012,7,0,5,1,Cloudy,0.665833,0.613025,0.844167,0.208967,747,5123,5870,164,567,5870,0
568,2012-07-21,Fall,2012,7,0,6,0,Rain,0.595833,0.549912,0.865417,0.2133,1264,3195,4459,163,568,4459,2
569,2012-07-22,Fall,2012,7,0,0,0,Cloudy,0.6675,0.623125,0.7625,0.0939208,2544,4866,7410,162,569,7410,0
570,2012-07-23,Fall,2012,7,0,1,1,Clear,0.741667,0.690017,0.694167,0.138683,1135,5831,6966,161,570,6966,0
571,2012-07-24,Fall,2012,7,0,2,1,Clear,0.750833,0.70645,0.655,0.211454,1140,6452,7592,160,571,7592,0
572,2012-07-25,Fall,2012,7,0,3,1,Clear,0.724167,0.654054,0.45,0.1648,1383,6790,8173,159,572,8173,0
573,2012-07-26,Fall,2012,7,0,4,1,Clear,0.776667,0.739263,0.596667,0.284813,1036,5825,6861,158,573,6861,0
574,2012-07-27,Fall,2012,7,0,5,1,Clear,0.781667,0.734217,0.594583,0.152992,1259,5645,6904,157,574,6904,0
575,2012-07-28,Fall,2012,7,0,6,0,Clear,0.755833,0.697604,0.613333,0.15735,2234,4451,6685,156,575,6685,0
576,2012-07-29,Fall,2012,7,0,0,0,Clear,0.721667,0.667933,0.62375,0.170396,2153,4444,6597,155,576,6597,0
577,2012-07-30,Fall,2012,7,0,1,1,Clear,0.730833,0.684987,0.66875,0.153617,1040,6065,7105,154,577,7105,0
578,2012-07-31,Fall,2012,7,0,2,1,Clear,0.713333,0.662896,0.704167,0.165425,968,6248,7216,153,578,7216,0
579,2012-08-01,Fall,2012,8,0,3,1,Clear,0.7175,0.667308,0.6775,0.141179,1074,6506,7580,152,579,7580,0
580,2012-08-02,Fall,2012,8,0,4,1,Clear,0.7525,0.707088,0.659583,0.129354,983,6278,7261,151,580,7261,0
581,2012-08-03,Fall,2012,8,0,5,1,Cloudy,0.765833,0.722867,0.6425,0.215792,1328,5847,7175,150,581,7175,0
582,2012-08-04,Fall,2012,8,0,6,0,Clear,0.793333,0.751267,0.613333,0.257458,2345,4479,6824,149,582,6824,0
583,2012-08-05,Fall,2012,8,0,0,0,Clear,0.769167,0.731079,0.6525,0.290421,1707,3757,5464,148,583,5464,2
584,2012-08-06,Fall,2012,8,0,1,1,Cloudy,0.7525,0.710246,0.654167,0.129354,1233,5780,7013,147,584,7013,0
585,2012-08-07,Fall,2012,8,0,2,1,Cloudy,0.735833,0.697621,0.70375,0.116908,1278,5995,7273,146,585,7273,0
586,2012-08-08,Fall,2012,8,0,3,1,Cloudy,0.75,0.707717,0.672917,0.1107,1263,6271,7534,145,586,7534,0
587,2012-08-09,Fall,2012,8,0,4,1,Clear,0.755833,0.699508,0.620417,0.1561,1196,6090,7286,144,587,7286,0
588,2012-08-10,Fall,2012,8,0,5,1,Cloudy,0.715833,0.667942,0.715833,0.238813,1065,4721,5786,143,588,5786,0
589,2012-08-11,Fall,2012,8,0,6,0,Cloudy,0.6925,0.638267,0.732917,0.206479,2247,4052,6299,142,589,6299,0
590,2012-08-12,Fall,2012,8,0,0,0,Clear,0.700833,0.644579,0.530417,0.122512,2182,4362,6544,141,590,6544,0
591,2012-08-13,Fall,2012,8,0,1,1,Clear,0.720833,0.662254,0.545417,0.136212,1207,5676,6883,140,591,6883,0
592,2012-08-14,Fall,2012,8,0,2,1,Clear,0.726667,0.676779,0.686667,0.169158,1128,5656,6784,139,592,6784,0
593,2012-08-15,Fall,2012,8,0,3,1,Clear,0.706667,0.654037,0.619583,0.169771,1198,6149,7347,138,593,7347,0
594,2012-08-16,Fall,2012,8,0,4,1,Clear,0.719167,0.654688,0.519167,0.141796,1338,6267,7605,137,594,7605,0
595,2012-08-17,Fall,2012,8,0,5,1,Clear,0.723333,0.2424,0.570833,0.231354,1483,5665,7148,136,595,7148,0
596,2012-08-18,Fall,2012,8,0,6,0,Clear,0.678333,0.618071,0.603333,0.177867,2827,5038,7865,135,596,7865,0
597,2012-08-19,Fall,2012,8,0,0,0,Cloudy,0.635833,0.603554,0.711667,0.08645,1208,3341,4549,134,597,4549,2
598,2012-08-20,Fall,2012,8,0,1,1,Cloudy,0.635833,0.595967,0.734167,0.129979,1026,5504,6530,133,598,6530,0
599,2012-08-21,Fall,2012,8,0,2,1,Clear,0.649167,0.601025,0.67375,0.0727708,1081,5925,7006,132,599,7006,0
600,2012-08-22,Fall,2012,8,0,3,1,Clear,0.6675,0.621854,0.677083,0.0702833,1094,6281,7375,131,600,7375,0
601,2012-08-23,Fall,2012,8,0,4,1,Clear,0.695833,0.637008,0.635833,0.0845958,1363,6402,7765,130,601,7765,0
602,2012-08-24,Fall,2012,8,0,5,1,Cloudy,0.7025,0.6471,0.615,0.0721458,1325,6257,7582,129,602,7582,0
603,2012-08-25,Fall,2012,8,0,6,0,Cloudy,0.661667,0.618696,0.712917,0.244408,1829,4224,6053,128,603,6053,0
604,2012-08-26,Fall,2012,8,0,0,0,Cloudy,0.653333,0.595996,0.845833,0.228858,1483,3772,5255,127,604,5255,2
605,2012-08-27,Fall,2012,8,0,1,1,Clear,0.703333,0.654688,0.730417,0.128733,989,5928,6917,126,605,6917,0
606,2012-08-28,Fall,2012,8,0,2,1,Clear,0.728333,0.66605,0.62,0.190925,935,6105,7040,125,606,7040,0
607,2012-08-29,Fall,2012,8,0,3,1,Clear,0.685,0.635733,0.552083,0.112562,1177,6520,7697,124,607,7697,0
608,2012-08-30,Fall,2012,8,0,4,1,Clear,0.706667,0.652779,0.590417,0.0771167,1172,6541,7713,123,608,7713,0
609,2012-08-31,Fall,2012,8,0,5,1,Clear,0.764167,0.6894,0.5875,0.168533,1433,5917,7350,122,609,7350,0
610,2012-09-01,Fall,2012,9,0,6,0,Cloudy,0.753333,0.702654,0.638333,0.113187,2352,3788,6140,121,610,6140,0
611,2012-09-02,Fall,2012,9,0,0,0,Cloudy,0.696667,0.649,0.815,0.0640708,2613,3197,5810,120,611,5810,0
612,2012-09-03,Fall,2012,9,1,1,0,Clear,0.7075,0.661629,0.790833,0.151121,1965,4069,6034,119,612,6034,0
613,2012-09-04,Fall,2012,9,0,2,1,Clear,0.725833,0.686888,0.755,0.236321,867,5997,6864,118,613,6864,0
614,2012-09-05,Fall,2012,9,0,3,1,Clear,0.736667,0.708983,0.74125,0.187808,832,6280,7112,117,614,7112,0
615,2012-09-06,Fall,2012,9,0,4,1,Cloudy,0.696667,0.655329,0.810417,0.142421,611,5592,6203,116,615,6203,0
616,2012-09-07,Fall,2012,9,0,5,1,Clear,0.703333,0.657204,0.73625,0.171646,1045,6459,7504,115,616,7504,0
617,2012-09-08,Fall,2012,9,0,6,0,Cloudy,0.659167,0.611121,0.799167,0.281104,1557,4419,5976,114,617,5976,0
618,2012-09-09,Fall,2012,9,0,0,0,Clear,0.61,0.578925,0.5475,0.224496,2570,5657,8227,113,618,8227,0
619,2012-09-10,Fall,2012,9,0,1,1,Clear,0.583333,0.565654,0.50375,0.258713,1118,6407,7525,112,619,7525,0
620,2012-09-11,Fall,2012,9,0,2,1,Clear,0.5775,0.554292,0.52,0.0920542,1070,6697,7767,111,620,7767,0
621,2012-09-12,Fall,2012,9,0,3,1,Clear,0.599167,0.570075,0.577083,0.131846,1050,6820,7870,110,621,7870,0
622,2012-09-13,Fall,2012,9,0,4,1,Clear,0.6125,0.579558,0.637083,0.0827208,1054,6750,7804,109,622,7804,0
623,2012-09-14,Fall,2012,9,0,5,1,Clear,0.633333,0.594083,0.6725,0.103863,1379,6630,8009,108,623,8009,0
624,2012-09-15,Fall,2012,9,0,6,0,Clear,0.608333,0.585867,0.501667,0.247521,3160,5554,8714,107,624,8714,0
625,2012-09-16,Fall,2012,9,0,0,0,Clear,0.58,0.563125,0.57,0.0901833,2166,5167,7333,106,625,7333,0
626,2012-09-17,Fall,2012,9,0,1,1,Cloudy,0.580833,0.55305,0.734583,0.151742,1022,5847,6869,105,626,6869,0
627,2012-09-18,Fall,2012,9,0,2,1,Cloudy,0.623333,0.565067,0.8725,0.357587,371,3702,4073,104,627,4073,2
628,2012-09-19,Fall,2012,9,0,3,1,Clear,0.5525,0.540404,0.536667,0.215175,788,6803,7591,103,628,7591,0
629,2012-09-20,Fall,2012,9,0,4,1,Clear,0.546667,0.532192,0.618333,0.118167,939,6781,7720,102,629,7720,0
630,2012-09-21,Fall,2012,9,0,5,1,Clear,0.599167,0.571971,0.66875,0.154229,1250,6917,8167,101,630,8167,0
631,2012-09-22,Fall,2012,9,0,6,0,Clear,0.65,0.610488,0.646667,0.283583,2512,5883,8395,100,631,8395,0
632,2012-09-23,Winter,2012,9,0,0,0,Clear,0.529167,0.518933,0.467083,0.223258,2454,5453,7907,99,632,7907,0
633,2012-09-24,Winter,2012,9,0,1,1,Clear,0.514167,0.502513,0.492917,0.142404,1001,6435,7436,98,633,7436,0
634,2012-09-25,Winter,2012,9,0,2,1,Clear,0.55,0.544179,0.57,0.236321,845,6693,7538,97,634,7538,0
635,2012-09-26,Winter,2012,9,0,3,1,Clear,0.635,0.596613,0.630833,0.2444,787,6946,7733,96,635,7733,0
636,2012-09-27,Winter,2012,9,0,4,1,Cloudy,0.65,0.607975,0.690833,0.134342,751,6642,7393,95,636,7393,0
637,2012-09-28,Winter,2012,9,0,5,1,Cloudy,0.619167,0.585863,0.69,0.164179,1045,6370,7415,94,637,7415,0
638,2012-09-29,Winter,2012,9,0,6,0,Clear,0.5425,0.530296,0.542917,0.227604,2589,5966,8555,93,638,8555,0
639,2012-09-30,Winter,2012,9,0,0,0,Clear,0.526667,0.517663,0.583333,0.134958,2015,4874,6889,92,639,6889,0
640,2012-10-01,Winter,2012,10,0,1,1,Cloudy,0.520833,0.512,0.649167,0.0908042,763,6015,6778,91,640,6778,0
641,2012-10-02,Winter,2012,10,0,2,1,Rain,0.590833,0.542333,0.871667,0.104475,315,4324,4639,90,641,4639,2
642,2012-10-03,Winter,2012,10,0,3,1,Cloudy,0.6575,0.599133,0.79375,0.0665458,728,6844,7572,89,642,7572,0
643,2012-10-04,Winter,2012,10,0,4,1,Cloudy,0.6575,0.607975,0.722917,0.117546,891,6437,7328,88,643,7328,0
644,2012-10-05,Winter,2012,10,0,5,1,Clear,0.615,0.580187,0.6275,0.10635,1516,6640,8156,87,644,8156,0
645,2012-10-06,Winter,2012,10,0,6,0,Clear,0.554167,0.538521,0.664167,0.268025,3031,4934,7965,86,645,7965,0
646,2012-10-07,Winter,2012,10,0,0,0,Cloudy,0.415833,0.419813,0.708333,0.141162,781,2729,3510,85,646,3510,2
647,2012-10-08,Winter,2012,10,1,1,0,Cloudy,0.383333,0.387608,0.709583,0.189679,874,4604,5478,84,647,5478,2
648,2012-10-09,Winter,2012,10,0,2,1,Cloudy,0.446667,0.438112,0.761667,0.1903,601,5791,6392,83,648,6392,0
649,2012-10-10,Winter,2012,10,0,3,1,Clear,0.514167,0.503142,0.630833,0.187821,780,6911,7691,82,649,7691,0
650,2012-10-11,Winter,2012,10,0,4,1,Clear,0.435,0.431167,0.463333,0.181596,834,6736,7570,81,650,7570,0
651,2012-10-12,Winter,2012,10,0,5,1,Clear,0.4375,0.433071,0.539167,0.235092,1060,6222,7282,80,651,7282,0
652,2012-10-13,Winter,2012,10,0,6,0,Clear,0.393333,0.391396,0.494583,0.146142,2252,4857,7109,79,652,7109,0
653,2012-10-14,Winter,2012,10,0,0,0,Clear,0.521667,0.508204,0.640417,0.278612,2080,4559,6639,78,653,6639,0
654,2012-10-15,Winter,2012,10,0,1,1,Cloudy,0.561667,0.53915,0.7075,0.296037,760,5115,5875,77,654,5875,0
655,2012-10-16,Winter,2012,10,0,2,1,Clear,0.468333,0.460846,0.558333,0.182221,922,6612,7534,76,655,7534,0
656,2012-10-17,Winter,2012,10,0,3,1,Clear,0.455833,0.450108,0.692917,0.101371,979,6482,7461,75,656,7461,0
657,2012-10-18,Winter,2012,10,0,4,1,Cloudy,0.5225,0.512625,0.728333,0.236937,1008,6501,7509,74,657,7509,0
658,2012-10-19,Winter,2012,10,0,5,1,Cloudy,0.563333,0.537896,0.815,0.134954,753,4671,5424,73,658,5424,2
659,2012-10-20,Winter,2012,10,0,6,0,Clear,0.484167,0.472842,0.572917,0.117537,2806,5284,8090,72,659,8090,0
660,2012-10-21,Winter,2012,10,0,0,0,Clear,0.464167,0.456429,0.51,0.166054,2132,4692,6824,71,660,6824,0
661,2012-10-22,Winter,2012,10,0,1,1,Clear,0.4875,0.482942,0.568333,0.0814833,830,6228,7058,70,661,7058,0
662,2012-10-23,Winter,2012,10,0,2,1,Clear,0.544167,0.530304,0.641667,0.0945458,841,6625,7466,69,662,7466,0
663,2012-10-24,Winter,2012,10,0,3,1,Clear,0.5875,0.558721,0.63625,0.0727792,795,6898,7693,68,663,7693,0
664,2012-10-25,Winter,2012,10,0,4,1,Cloudy,0.55,0.529688,0.800417,0.124375,875,6484,7359,67,664,7359,0
665,2012-10-26,Winter,2012,10,0,5,1,Cloudy,0.545833,0.52275,0.807083,0.132467,1182,6262,7444,66,665,7444,0
666,2012-10-27,Winter,2012,10,0,6,0,Cloudy,0.53,0.515133,0.72,0.235692,2643,5209,7852,65,666,7852,0
667,2012-10-28,Winter,2012,10,0,0,0,Cloudy,0.4775,0.467771,0.694583,0.398008,998,3461,4459,64,667,4459,2
668,2012-10-29,Winter,2012,10,0,1,1,Rain,0.44,0.4394,0.88,0.3582,2,20,22,63,668,22,1
669,2012-10-30,Winter,2012,10,0,2,1,Cloudy,0.318182,0.309909,0.825455,0.213009,87,1009,1096,62,669,1096,1
670,2012-10-31,Winter,2012,10,0,3,1,Cloudy,0.3575,0.3611,0.666667,0.166667,419,5147,5566,61,670,5566,2
671,2012-11-01,Winter,2012,11,0,4,1,Cloudy,0.365833,0.369942,0.581667,0.157346,466,5520,5986,60,671,5986,0
672,2012-11-02,Winter,2012,11,0,5,1,Clear,0.355,0.356042,0.522083,0.266175,618,5229,5847,59,672,5847,0
673,2012-11-03,Winter,2012,11,0,6,0,Cloudy,0.343333,0.323846,0.49125,0.270529,1029,4109,5138,58,673,5138,2
674,2012-11-04,Winter,2012,11,0,0,0,Clear,0.325833,0.329538,0.532917,0.179108,1201,3906,5107,57,674,5107,2
675,2012-11-05,Winter,2012,11,0,1,1,Clear,0.319167,0.308075,0.494167,0.236325,378,4881,5259,56,675,5259,2
676,2012-11-06,Winter,2012,11,0,2,1,Clear,0.280833,0.281567,0.567083,0.173513,466,5220,5686,55,676,5686,0
677,2012-11-07,Winter,2012,11,0,3,1,Cloudy,0.295833,0.274621,0.5475,0.304108,326,4709,5035,54,677,5035,2
678,2012-11-08,Winter,2012,11,0,4,1,Clear,0.352174,0.341891,0.333478,0.347835,340,4975,5315,53,678,5315,2
679,2012-11-09,Winter,2012,11,0,5,1,Clear,0.361667,0.355413,0.540833,0.214558,709,5283,5992,52,679,5992,0
680,2012-11-10,Winter,2012,11,0,6,0,Clear,0.389167,0.393937,0.645417,0.0578458,2090,4446,6536,51,680,6536,0
681,2012-11-11,Winter,2012,11,0,0,0,Clear,0.420833,0.421713,0.659167,0.1275,2290,4562,6852,50,681,6852,0
682,2012-11-12,Winter,2012,11,1,1,0,Clear,0.485,0.475383,0.741667,0.173517,1097,5172,6269,49,682,6269,0
683,2012-11-13,Winter,2012,11,0,2,1,Cloudy,0.343333,0.323225,0.662917,0.342046,327,3767,4094,48,683,4094,2
684,2012-11-14,Winter,2012,11,0,3,1,Clear,0.289167,0.281563,0.552083,0.199625,373,5122,5495,47,684,5495,2
685,2012-11-15,Winter,2012,11,0,4,1,Cloudy,0.321667,0.324492,0.620417,0.152987,320,5125,5445,46,685,5445,2
686,2012-11-16,Winter,2012,11,0,5,1,Clear,0.345,0.347204,0.524583,0.171025,484,5214,5698,45,686,5698,0
687,2012-11-17,Winter,2012,11,0,6,0,Clear,0.325,0.326383,0.545417,0.179729,1313,4316,5629,44,687,5629,2
688,2012-11-18,Winter,2012,11,0,0,0,Clear,0.3425,0.337746,0.692917,0.227612,922,3747,4669,43,688,4669,2
689,2012-11-19,Winter,2012,11,0,1,1,Cloudy,0.380833,0.375621,0.623333,0.235067,449,5050,5499,42,689,5499,2
690,2012-11-20,Winter,2012,11,0,2,1,Cloudy,0.374167,0.380667,0.685,0.082725,534,5100,5634,41,690,5634,2
691,2012-11-21,Winter,2012,11,0,3,1,Clear,0.353333,0.364892,0.61375,0.103246,615,4531,5146,40,691,5146,2
692,2012-11-22,Winter,2012,11,1,4,0,Clear,0.34,0.350371,0.580417,0.0528708,955,1470,2425,39,692,2425,1
693,2012-11-23,Winter,2012,11,0,5,1,Clear,0.368333,0.378779,0.56875,0.148021,1603,2307,3910,38,693,3910,2
694,2012-11-24,Winter,2012,11,0,6,0,Clear,0.278333,0.248742,0.404583,0.376871,532,1745,2277,37,694,2277,1
695,2012-11-25,Winter,2012,11,0,0,0,Clear,0.245833,0.257583,0.468333,0.1505,309,2115,2424,36,695,2424,1
696,2012-11-26,Winter,2012,11,0,1,1,Clear,0.313333,0.339004,0.535417,0.04665,337,4750,5087,35,696,5087,2
697,2012-11-27,Winter,2012,11,0,2,1,Cloudy,0.291667,0.281558,0.786667,0.237562,123,3836,3959,34,697,3959,2
698,2012-11-28,Winter,2012,11,0,3,1,Clear,0.296667,0.289762,0.50625,0.210821,198,5062,5260,33,698,5260,2
699,2012-11-29,Winter,2012,11,0,4,1,Clear,0.28087,0.298422,0.555652,0.115522,243,5080,5323,32,699,5323,2
700,2012-11-30,Winter,2012,11,0,5,1,Clear,0.298333,0.323867,0.649583,0.0584708,362,5306,5668,31,700,5668,0
701,2012-12-01,Winter,2012,12,0,6,0,Cloudy,0.298333,0.316904,0.806667,0.0597042,951,4240,5191,30,701,5191,2
702,2012-12-02,Winter,2012,12,0,0,0,Cloudy,0.3475,0.359208,0.823333,0.124379,892,3757,4649,29,702,4649,2
703,2012-12-03,Winter,2012,12,0,1,1,Clear,0.4525,0.455796,0.7675,0.0827208,555,5679,6234,28,703,6234,0
704,2012-12-04,Winter,2012,12,0,2,1,Clear,0.475833,0.469054,0.73375,0.174129,551,6055,6606,27,704,6606,0
705,2012-12-05,Winter,2012,12,0,3,1,Clear,0.438333,0.428012,0.485,0.324021,331,5398,5729,26,705,5729,0
706,2012-12-06,Winter,2012,12,0,4,1,Clear,0.255833,0.258204,0.50875,0.174754,340,5035,5375,25,706,5375,2
707,2012-12-07,Winter,2012,12,0,5,1,Cloudy,0.320833,0.321958,0.764167,0.1306,349,4659,5008,24,707,5008,2
708,2012-12-08,Winter,2012,12,0,6,0,Cloudy,0.381667,0.389508,0.91125,0.101379,1153,4429,5582,23,708,5582,2
709,2012-12-09,Winter,2012,12,0,0,0,Cloudy,0.384167,0.390146,0.905417,0.157975,441,2787,3228,22,709,3228,2
710,2012-12-10,Winter,2012,12,0,1,1,Cloudy,0.435833,0.435575,0.925,0.190308,329,4841,5170,21,710,5170,2
711,2012-12-11,Winter,2012,12,0,2,1,Cloudy,0.353333,0.338363,0.596667,0.296037,282,5219,5501,20,711,5501,2
712,2012-12-12,Winter,2012,12,0,3,1,Cloudy,0.2975,0.297338,0.538333,0.162937,310,5009,5319,19,712,5319,2
713,2012-12-13,Winter,2012,12,0,4,1,Clear,0.295833,0.294188,0.485833,0.174129,425,5107,5532,18,713,5532,2
714,2012-12-14,Winter,2012,12,0,5,1,Clear,0.281667,0.294192,0.642917,0.131229,429,5182,5611,17,714,5611,2
715,2012-12-15,Winter,2012,12,0,6,0,Clear,0.324167,0.338383,0.650417,0.10635,767,4280,5047,16,715,5047,2
716,2012-12-16,Winter,2012,12,0,0,0,Cloudy,0.3625,0.369938,0.83875,0.100742,538,3248,3786,15,716,3786,2
717,2012-12-17,Winter,2012,12,0,1,1,Cloudy,0.393333,0.4015,0.907083,0.0982583,212,4373,4585,14,717,4585,2
718,2012-12-18,Winter,2012,12,0,2,1,Clear,0.410833,0.409708,0.66625,0.221404,433,5124,5557,13,718,5557,2
719,2012-12-19,Winter,2012,12,0,3,1,Clear,0.3325,0.342162,0.625417,0.184092,333,4934,5267,12,719,5267,2
720,2012-12-20,Winter,2012,12,0,4,1,Cloudy,0.33,0.335217,0.667917,0.132463,314,3814,4128,11,720,4128,2
721,2012-12-21,Spring,2012,12,0,5,1,Cloudy,0.326667,0.301767,0.556667,0.374383,221,3402,3623,10,721,3623,2
722,2012-12-22,Spring,2012,12,0,6,0,Clear,0.265833,0.236113,0.44125,0.407346,205,1544,1749,9,722,1749,1
723,2012-12-23,Spring,2012,12,0,0,0,Clear,0.245833,0.259471,0.515417,0.133083,408,1379,1787,8,723,1787,1
724,2012-12-24,Spring,2012,12,0,1,1,Cloudy,0.231304,0.2589,0.791304,0.0772304,174,746,920,7,724,920,1
725,2012-12-25,Spring,2012,12,1,2,0,Cloudy,0.291304,0.294465,0.734783,0.168726,440,573,1013,6,725,1013,1
726,2012-12-26,Spring,2012,12,0,3,1,Rain,0.243333,0.220333,0.823333,0.316546,9,432,441,5,726,441,1
727,2012-12-27,Spring,2012,12,0,4,1,Cloudy,0.254167,0.226642,0.652917,0.350133,247,1867,2114,4,727,2114,1
728,2012-12-28,Spring,2012,12,0,5,1,Cloudy,0.253333,0.255046,0.59,0.155471,644,2451,3095,3,728,3095,1
729,2012-12-29,Spring,2012,12,0,6,0,Cloudy,0.253333,0.2424,0.752917,0.124383,159,1182,1341,2,729,1341,1
730,2012-12-30,Spring,2012,12,0,0,0,Clear,0.255833,0.2317,0.483333,0.350754,364,1432,1796,1,730,1796,1
731,2012-12-31,Spring,2012,12,0,1,1,Cloudy,0.215833,0.223487,0.5775,0.154846,439,2290,2729,0,731,2729,1
